ID;DNI;Ideconomico;Ingresos;GastosMensuales;Balance
1;32953689;100;2979;1222;1757
2;32978283;101;2662;1305;1357
3;32979152;102;2847;1396;1451
4;32868748;103;1788;894;894
5;32736271;104;2455;1203;1252
6;32852122;105;2040;796;1244
7;32958356;106;2548;1300;1248
8;32956890;107;2097;1028;1069
9;32860171;108;1852;908;944
10;32989487;109;2754;1267;1487
11;32969099;110;1512;636;876
12;80224737;111;2274;1047;1227
13;41115441;112;2422;969;1453
14;25831470;113;1766;848;918
15;40181963;114;1851;796;1055
16;32813686;115;1898;779;1119
17;32987819;116;1938;873;1065
18;17554728;117;2091;941;1150
19;32979740;118;2653;1221;1432
20;32983142;119;2158;907;1251
21;32981898;120;1839;736;1103
22;32818810;121;2590;1244;1346
23;32847967;122;1836;772;1064
24;32915750;123;1845;923;922
25;32944990;124;2765;1328;1437
26;43185683;125;2991;1287;1704
27;42018111;126;2904;1365;1539
28;45415840;127;1640;738;902
29;40011464;128;1876;751;1125
30;32831690;129;1598;624;974
31;40627190;130;2061;928;1133
32;3124096;131;2217;1087;1130
33;32979648;132;2470;1013;1457
34;80314411;133;2088;1065;1023
35;40464132;134;2132;1024;1108
36;32945976;135;2292;917;1375
37;41618620;136;2686;1182;1504
38;32852139;137;1644;707;937
39;32965893;138;2913;1486;1427
40;17923862;139;1806;741;1065
41;25806297;140;2374;1093;1281
42;17881034;141;2886;1126;1760
43;32942094;142;2438;1171;1267
44;32954779;143;2740;1179;1561
45;32964195;144;2922;1461;1461
46;41542442;145;2695;1132;1563
47;31673615;146;2459;960;1499
48;32808026;147;2708;1057;1651
49;72418981;148;2201;991;1210
50;41579351;149;2720;1197;1523
51;80171747;150;1778;729;1049
52;8638845;151;2775;1388;1387
53;45215276;152;2262;1041;1221
54;18492323;153;2394;1150;1244
55;73422693;154;2174;957;1217
56;40331466;155;1969;965;1004
57;77490872;156;2810;1237;1573
58;32849940;157;1918;902;1016
59;32927065;158;2944;1414;1530
60;43407667;159;2912;1369;1543
61;32982761;160;2667;1201;1466
62;40446693;161;2409;1157;1252
63;32982993;162;2157;1101;1056
64;18023384;163;1616;744;872
65;48206364;164;1909;860;1049
66;112022;165;1726;708;1018
67;32820013;166;2378;1213;1165
68;70121204;167;2749;1238;1511
69;43451364;168;1808;742;1066
70;45623464;169;2363;1158;1205
71;32899688;170;2626;1077;1549
72;47659163;171;1954;782;1172
73;32949546;172;2703;1352;1351
74;32987914;173;2455;1007;1448
75;42222210;174;1557;670;887
76;44182440;175;2768;1108;1660
77;33264339;176;2195;1054;1141
78;32895058;177;1523;686;837
79;32891155;178;2388;1051;1337
80;32903928;179;2947;1297;1650
81;32922044;180;2956;1331;1625
82;32738480;181;1623;763;860
83;32922246;182;1570;707;863
84;32946608;183;1820;783;1037
85;32970572;184;2851;1198;1653
86;41190227;185;1725;863;862
87;32889773;186;2292;1009;1283
88;32985110;187;2189;1051;1138
89;32898518;188;2631;1079;1552
90;43472987;189;1921;865;1056
91;32893804;190;1573;645;928
92;32893967;191;2009;804;1205
93;41841391;192;2596;1195;1401
94;44476943;193;2585;1267;1318
95;40629898;194;2542;1017;1525
96;32889494;195;2500;1050;1450
97;32891847;196;1553;699;854
98;32984164;197;2185;1027;1158
99;32889254;198;2194;966;1228
100;32992688;199;1720;740;980
101;41405245;200;1761;740;1021
102;44667646;201;2435;1169;1266
103;32899899;202;2205;1037;1168
104;41355087;203;1541;756;785
105;42664570;204;1553;653;900
106;41228925;205;2042;1001;1041
107;32897010;206;2914;1254;1660
108;32894238;207;1813;726;1087
109;32891497;208;2746;1346;1400
110;32738444;209;2020;849;1171
111;41401705;210;1645;642;1003
112;32919897;211;1934;774;1160
113;46391966;212;1580;759;821
114;42071126;213;2152;1012;1140
115;32897514;214;2160;972;1188
116;32902193;215;2049;1005;1044
117;45043378;216;1859;800;1059
118;45531826;217;2725;1145;1580
119;32900609;218;1803;866;937
120;40265622;219;1816;927;889
121;43707219;220;2756;1186;1570
122;45012698;221;1953;938;1015
123;32734562;222;2935;1292;1643
124;32947960;223;1833;917;916
125;43558433;224;1974;869;1105
126;32891474;225;1695;797;898
127;45693008;226;2748;1374;1374
128;32734276;227;2367;971;1396
129;80207050;228;2134;1046;1088
130;32946552;229;1870;786;1084
131;32900748;230;1930;753;1177
132;46191487;231;1517;607;910
133;40984449;232;2631;1053;1578
134;44786944;233;1674;804;870
135;43447124;234;2789;1256;1533
136;32828425;235;2999;1200;1799
137;32790367;236;1620;778;842
138;32912249;237;2609;1070;1539
139;32824398;238;1626;765;861
140;32859980;239;2397;1175;1222
141;32973527;240;1514;667;847
142;40234570;241;2612;1098;1514
143;33259941;242;2354;966;1388
144;32867165;243;2346;915;1431
145;32818482;244;2955;1330;1625
146;32925807;245;2035;835;1200
147;32905897;246;1786;893;893
148;32845631;247;1797;845;952
149;32915848;248;2484;1044;1440
150;32873179;249;2664;1359;1305
151;32775923;250;2516;1108;1408
152;32781231;251;1864;802;1062
153;32800063;252;2184;1071;1113
154;40694340;253;2637;1161;1476
155;40951528;254;1892;814;1078
156;32798321;255;2730;1229;1501
157;32840741;256;2493;1272;1221
158;32771969;257;2117;953;1164
159;32887800;258;1833;752;1081
160;8258402;259;1804;794;1010
161;32909721;260;2120;976;1144
162;22498743;261;2086;981;1105
163;41212345;262;1689;693;996
164;32971058;263;2666;1333;1333
165;32817262;264;2550;1020;1530
166;32857399;265;2127;873;1254
167;32817215;266;2285;1143;1142
168;32971207;267;1540;663;877
169;43411505;268;2080;957;1123
170;82922597;269;2323;1046;1277
171;41002944;270;2624;1129;1495
172;32978914;271;2270;977;1293
173;33260168;272;2157;1079;1078
174;42761500;273;1844;775;1069
175;44051054;274;1683;792;891
176;32918842;275;2573;1030;1543
177;33261581;276;2224;1046;1178
178;33260070;277;2905;1192;1713
179;32964289;278;1524;778;746
180;32873040;279;2184;1049;1135
181;32865748;280;2858;1287;1571
182;32816970;281;2369;1114;1255
183;44756532;282;2282;1005;1277
184;32788032;283;2287;1007;1280
185;32488601;284;1548;620;928
186;32843534;285;1767;743;1024
187;32885724;286;2296;988;1308
188;43112018;287;2686;1209;1477
189;32811380;288;2755;1213;1542
190;32784731;289;2609;1070;1539
191;32846236;290;2618;1048;1570
192;47850359;291;1780;890;890
193;71085193;292;2020;1031;989
194;70117168;293;2931;1319;1612
195;32853366;294;2815;1211;1604
196;46403966;295;1812;870;942
197;46100461;296;2592;1167;1425
198;32805828;297;2678;1179;1499
199;32846145;298;2778;1195;1583
200;74527619;299;2652;1061;1591
201;47434264;300;1796;773;1023
202;76208907;301;2121;849;1272
203;41783096;302;2541;1144;1397
204;41864203;303;2415;942;1473
205;32916546;304;2829;1302;1527
206;32922597;305;2231;1004;1227
207;32792954;306;2122;892;1230
208;32807631;307;1609;660;949
209;32788251;308;2576;1185;1391
210;15851610;309;2775;1277;1498
211;40956203;310;2461;1059;1402
212;40951537;311;2601;1119;1482
213;32924522;312;2579;1058;1521
214;44043297;313;2510;979;1531
215;44515610;314;2561;999;1562
216;32864068;315;2719;1306;1413
217;73613582;316;1617;777;840
218;32867341;317;1524;762;762
219;43811143;318;2323;1139;1184
220;41671483;319;2841;1307;1534
221;48420796;320;2153;862;1291
222;10505866;321;1815;817;998
223;32932764;322;2213;930;1283
224;32835884;323;2041;837;1204
225;32934342;324;1687;760;927
226;32918747;325;2623;1286;1337
227;32913720;326;1517;607;910
228;32915083;327;1642;789;853
229;32865669;328;2221;1067;1154
230;40461696;329;2475;1213;1262
231;32901523;330;2630;1158;1472
232;23093857;331;1594;782;812
233;32875845;332;1711;805;906
234;2776416;333;1578;663;915
235;2862749;334;2415;1232;1183
236;32910136;335;2655;1089;1566
237;7115641;336;1813;853;960
238;43858001;337;2364;1159;1205
239;32738615;338;1834;936;898
240;32922997;339;1997;839;1158
241;32796103;340;2624;1129;1495
242;32976642;341;1945;876;1069
243;43536735;342;1759;722;1037
244;7555491;343;1534;675;859
245;42583448;344;2649;1087;1562
246;32915372;345;2411;965;1446
247;18879362;346;2706;1326;1380
248;32857510;347;1545;727;818
249;32833624;348;2365;946;1419
250;32953836;349;2372;1115;1257
251;40414467;350;2828;1414;1414
252;32906089;351;1960;922;1038
253;80195618;352;2737;1260;1477
254;32942619;353;1712;856;856
255;32793198;354;1776;729;1047
256;32939345;355;1732;797;935
257;32962006;356;1913;804;1109
258;32945572;357;2785;1282;1503
259;6849546;358;2697;1187;1510
260;32785094;359;2519;1260;1259
261;32842827;360;2274;1024;1250
262;40130526;361;2853;1398;1455
263;33265393;362;1516;622;894
264;44268148;363;1662;732;930
265;32907394;364;2747;1127;1620
266;32905789;365;1688;709;979
267;32985301;366;2534;989;1545
268;32137138;367;1958;882;1076
269;32839367;368;2778;1223;1555
270;32919459;369;1690;829;861
271;32542108;370;1878;752;1126
272;45056238;371;1928;830;1098
273;40080785;372;1999;900;1099
274;43670422;373;1916;748;1168
275;32982001;374;1990;816;1174
276;32973061;375;1529;689;840
277;32936865;376;2469;1260;1209
278;47347919;377;2710;1084;1626
279;42833368;378;1971;828;1143
280;43458592;379;2203;926;1277
281;32139561;380;2897;1159;1738
282;45684579;381;2847;1225;1622
283;33240133;382;2020;788;1232
284;41072781;383;2080;895;1185
285;32902838;384;1747;699;1048
286;32533416;385;2092;1046;1046
287;9757803;386;1559;764;795
288;32787234;387;2590;1166;1424
289;32940844;388;2870;1148;1722
290;70334097;389;1701;868;833
291;44824508;390;2285;1143;1142
292;40785749;391;1967;866;1101
293;41310784;392;2084;959;1125
294;71408612;393;1831;751;1080
295;48700505;394;2219;999;1220
296;32830846;395;1890;775;1115
297;17603913;396;2153;948;1205
298;41898192;397;2577;1134;1443
299;47524370;398;1608;660;948
300;40498186;399;2821;1185;1636
301;3369275;400;1668;651;1017
302;44029678;401;2669;1148;1521
303;32906815;402;1569;691;878
304;40591220;403;2978;1430;1548
305;45603234;404;2917;1255;1662
306;32958118;405;2589;1010;1579
307;40153264;406;2486;1069;1417
308;32990737;407;2831;1218;1613
309;32959171;408;1795;754;1041
310;32862274;409;1781;873;908
311;43347748;410;2760;1215;1545
312;32841241;411;2502;1026;1476
313;46520426;412;2670;1229;1441
314;41819238;413;2750;1348;1402
315;72712445;414;2133;1046;1087
316;32868407;415;2352;941;1411
317;60399254;416;2894;1216;1678
318;32834016;417;2178;1002;1176
319;76217395;418;1634;768;866
320;961625;419;1742;854;888
321;5245377;420;2824;1412;1412
322;70173108;421;2136;983;1153
323;80225716;422;2342;1078;1264
324;42858716;423;1546;743;803
325;42566473;424;2424;994;1430
326;32831041;425;2136;834;1302
327;45436414;426;2777;1139;1638
328;62046228;427;2292;1101;1191
329;32543107;428;2688;1344;1344
330;46315030;429;1725;880;845
331;75433233;430;2516;1233;1283
332;32919256;431;1748;805;943
333;32854458;432;2354;1013;1341
334;80192392;433;1934;832;1102
335;32810945;434;2636;1318;1318
336;32959782;435;2233;1117;1116
337;32859068;436;2457;1204;1253
338;32905465;437;2239;1030;1209
339;32847918;438;2164;1082;1082
340;32904348;439;2781;1224;1557
341;32825776;440;2568;1259;1309
342;32961669;441;2999;1320;1679
343;32820043;442;2615;1203;1412
344;32825777;443;2842;1137;1705
345;32888585;444;1590;764;826
346;32970942;445;2167;867;1300
347;41676438;446;2938;1293;1645
348;32774394;447;2548;1173;1375
349;32966719;448;2851;1169;1682
350;32798865;449;2077;1018;1059
351;44416789;450;2096;1007;1089
352;32912606;451;2766;1218;1548
353;32927244;452;1815;817;998
354;80249420;453;2493;1023;1470
355;32807619;454;2305;1015;1290
356;32783168;455;2452;1153;1299
357;32971735;456;2167;932;1235
358;32836800;457;2057;906;1151
359;32843491;458;2295;1079;1216
360;44860810;459;2523;1262;1261
361;32959425;460;2708;1219;1489
362;32915383;461;2178;1046;1132
363;42942000;462;2080;1020;1060
364;45809235;463;2509;1130;1379
365;32868999;464;1882;772;1110
366;32809817;465;2333;980;1353
367;42823104;466;2831;1331;1500
368;32953544;467;1742;837;905
369;80193867;468;2364;1088;1276
370;42828215;469;1945;817;1128
371;32979147;470;2115;995;1120
372;32977134;471;2136;1068;1068
373;40390890;472;1892;795;1097
374;32933400;473;1934;755;1179
375;40286433;474;2694;1132;1562
376;32978478;475;1651;661;990
377;17617321;476;1959;882;1077
378;32829683;477;2715;1141;1574
379;255516;478;2940;1500;1440
380;32844767;479;1701;834;867
381;32138848;480;2484;1044;1440
382;42405089;481;2010;865;1145
383;32920022;482;2071;829;1242
384;40779169;483;1977;890;1087
385;33265077;484;2577;1031;1546
386;32798545;485;2711;1193;1518
387;32783242;486;2868;1176;1692
388;40170468;487;1629;685;944
389;71276942;488;2017;848;1169
390;46435288;489;1835;790;1045
391;32979104;490;1654;827;827
392;40947943;491;1644;757;887
393;42841349;492;1716;876;840
394;16504499;493;2849;1254;1595
395;32807523;494;2388;1099;1289
396;45350772;495;1719;791;928
397;43548509;496;1959;823;1136
398;32927005;497;1550;713;837
399;43423509;498;1973;888;1085
400;40591343;499;2079;1019;1060
401;44741582;500;1970;848;1122
402;42219847;501;2872;1207;1665
403;40390887;502;2075;934;1141
404;60130743;503;1543;772;771
405;32951326;504;2536;1167;1369
406;32397108;505;1530;674;856
407;10534326;506;2390;1172;1218
408;32951788;507;2446;1199;1247
409;32791463;508;1968;866;1102
410;32959507;509;2675;1124;1551
411;32921731;510;1983;833;1150
412;40015450;511;2630;1079;1551
413;41469426;512;2402;961;1441
414;76740430;513;2759;1325;1434
415;70608184;514;2521;1059;1462
416;32907185;515;1957;979;978
417;40500536;516;1763;882;881
418;76826877;517;1536;661;875
419;48700847;518;1548;759;789
420;72843284;519;2187;985;1202
421;41359163;520;2472;1014;1458
422;72324485;521;1623;682;941
423;32964133;522;1597;719;878
424;73195171;523;2853;1284;1569
425;44778183;524;2921;1257;1664
426;48139881;525;2332;1097;1235
427;48678603;526;1951;956;995
428;32973428;527;2110;929;1181
429;41809684;528;2903;1220;1683
430;32980179;529;2297;1057;1240
431;32849225;530;2699;1269;1430
432;43850124;531;1854;779;1075
433;32907546;532;2876;1323;1553
434;32829290;533;1742;837;905
435;32923650;534;1633;784;849
436;32956831;535;2306;1107;1199
437;32906817;536;1681;740;941
438;32965388;537;1950;839;1111
439;40698330;538;1848;814;1034
440;46643221;539;2130;1002;1128
441;16698966;540;2366;1065;1301
442;32906920;541;1782;785;997
443;32907838;542;1593;717;876
444;32733900;543;2060;1010;1050
445;42982598;544;2562;1025;1537
446;45723986;545;1745;803;942
447;32788157;546;1787;912;875
448;47416694;547;1905;934;971
449;45090522;548;2964;1334;1630
450;19424574;549;2536;1040;1496
451;32911734;550;2250;1148;1102
452;32797054;551;2509;1130;1379
453;43857954;552;1933;870;1063
454;40945363;553;2511;1130;1381
455;32844367;554;2002;1001;1001
456;32740633;555;1713;874;839
457;41549501;556;1535;768;767
458;32839915;557;2974;1220;1754
459;32875203;558;1818;837;981
460;44095017;559;1699;765;934
461;47511568;560;2343;985;1358
462;32839827;561;2453;1129;1324
463;32880754;562;2391;1100;1291
464;32881047;563;1969;965;1004
465;32882431;564;2372;949;1423
466;8433532;565;1529;597;932
467;32883039;566;2312;925;1387
468;32927412;567;1722;793;929
469;32884763;568;2013;987;1026
470;32885042;569;2957;1242;1715
471;32881868;570;2369;1161;1208
472;32884669;571;1774;834;940
473;32883495;572;2214;1130;1084
474;7041047;573;2442;1124;1318
475;32988182;574;2804;1206;1598
476;32880561;575;2411;989;1422
477;32884325;576;2806;1375;1431
478;32882611;577;1548;728;820
479;32880574;578;1574;756;818
480;41616697;579;2430;997;1433
481;32883578;580;2137;984;1153
482;32887310;581;2472;1236;1236
483;32883609;582;2701;1297;1404
484;42352100;583;2401;1057;1344
485;80281123;584;2221;933;1288
486;32884719;585;1643;806;837
487;32881984;586;1723;724;999
488;32950734;587;2247;989;1258
489;32883691;588;2879;1354;1525
490;33261931;589;1571;707;864
491;42961358;590;1880;922;958
492;32881151;591;2970;1367;1603
493;40383425;592;2317;950;1367
494;32884965;593;2966;1335;1631
495;32734827;594;1654;712;942
496;32877785;595;1567;721;846
497;40309381;596;2050;1046;1004
498;32885398;597;1946;837;1109
499;32885285;598;2576;1237;1339
500;40340854;599;2485;1144;1341
501;32885570;600;2879;1469;1410
502;80307842;601;2569;1259;1310
503;9016939;602;2427;1214;1213
504;32738970;603;2687;1210;1477
505;45268514;604;1868;860;1008
506;8098305;605;2911;1194;1717
507;32885245;606;1567;784;783
508;32885385;607;1297;623;674
509;32881925;608;1498;630;868
510;32884999;609;1188;571;617
511;40870339;610;599;270;329
512;32884275;611;813;358;455
513;32884421;612;1042;501;541
514;32883032;613;1235;544;691
515;32884376;614;1006;403;603
516;32734806;615;2712;1058;1654
517;32986193;616;1993;818;1175
518;32738810;617;2581;1110;1471
519;32885265;618;1560;609;951
520;47077108;619;2852;1426;1426
521;42960037;620;2705;1110;1595
522;70202433;621;918;377;541
523;60652903;622;610;305;305
524;45299177;623;875;394;481
525;71850472;624;1131;487;644
526;41629518;625;917;431;486
527;9907798;626;524;221;303
528;7941722;627;508;260;248
529;32857870;628;714;343;371
530;32797830;629;994;438;556
531;32840865;630;1380;580;800
532;32857869;631;1309;642;667
533;32916557;632;1097;516;581
534;32733874;633;1056;412;644
535;32906663;634;541;249;292
536;32917435;635;686;275;411
537;32869196;636;923;453;470
538;32943009;637;1141;548;593
539;26957835;638;1009;485;524
540;4220986;639;1206;507;699
541;16613856;640;851;426;425
542;33265748;641;1347;620;727
543;32791172;642;1068;481;587
544;32917573;643;810;397;413
545;32542753;644;1076;463;613
546;33261304;645;789;324;465
547;43413890;646;1494;628;866
548;32939041;647;1037;457;580
549;32924344;648;1063;436;627
550;32968839;649;1378;565;813
551;32857605;650;727;349;378
552;32834934;651;900;387;513
553;32939067;652;1297;532;765
554;32925459;653;1494;613;881
555;32912652;654;1052;453;599
556;32917203;655;1284;527;757
557;32856311;656;2219;1066;1153
558;40290743;657;2924;1316;1608
559;41854974;658;1939;776;1163
560;80194074;659;2061;907;1154
561;32733203;660;2055;1007;1048
562;32740750;661;1578;632;946
563;32809528;662;2598;1092;1506
564;16665813;663;1473;590;883
565;32956621;664;1291;581;710
566;32965758;665;741;297;444
567;32876086;666;1084;456;628
568;44414228;667;547;225;322
569;26931402;668;597;233;364
570;80621693;669;802;385;417
571;45105726;670;1081;487;594
572;32929936;671;757;311;446
573;32805681;672;895;448;447
574;32879180;673;1067;523;544
575;80225767;674;1316;606;710
576;44876830;675;670;275;395
577;46328174;676;522;267;255
578;32917415;677;1075;538;537
579;32931478;678;922;397;525
580;32942757;679;958;479;479
581;32771631;680;524;257;267
582;33247549;681;832;325;507
583;18052478;682;1178;460;718
584;32887326;683;1147;494;653
585;80194826;684;973;477;496
586;32783976;685;2069;911;1158
587;80412431;686;2429;1191;1238
588;32740709;687;2280;1118;1162
589;40278181;688;1754;860;894
590;32791154;689;2790;1312;1478
591;48338033;690;2291;1031;1260
592;43022416;691;2889;1156;1733
593;47510081;692;2922;1403;1519
594;41563507;693;1024;512;512
595;74206686;694;1004;412;592
596;47886467;695;783;322;461
597;44182386;696;1112;501;611
598;32790317;697;1081;530;551
599;32760258;698;1245;573;672
600;1012444;699;750;360;390
601;41771970;700;1439;648;791
602;41665891;701;909;391;518
603;48222345;702;1067;545;522
604;48147443;703;1147;551;596
605;32911017;704;1021;409;612
606;42436509;705;738;369;369
607;46023334;706;1096;494;602
608;43969598;707;933;411;522
609;72731151;708;1295;570;725
610;45425610;709;1447;579;868
611;48716047;710;810;373;437
612;32869758;711;1108;444;664
613;46547874;712;1390;626;764
614;32861057;713;1469;676;793
615;42608477;714;1358;612;746
616;70375919;715;1279;576;703
617;32941121;716;857;360;497
618;45739370;717;922;388;534
619;32771240;718;832;408;424
620;71041496;719;1074;430;644
621;45256190;720;658;283;375
622;47369088;721;1459;672;787
623;41932200;722;1005;402;603
624;70375920;723;507;249;258
625;32962035;724;1220;610;610
626;32989672;725;828;332;496
627;42142990;726;1273;650;623
628;44419959;727;1265;557;708
629;48427036;728;1319;647;672
630;47510046;729;1053;516;537
631;32939179;730;1199;480;719
632;42671737;731;1067;417;650
633;32867134;732;1445;694;751
634;32809331;733;1305;549;756
635;32776978;734;525;242;283
636;32763761;735;619;291;328
637;32960479;736;868;365;503
638;32864880;737;615;308;307
639;32829314;738;1333;667;666
640;32888095;739;759;327;432
641;32783728;740;1101;562;539
642;17951060;741;1778;836;942
643;32868498;742;2185;918;1267
644;32818761;743;2744;1263;1481
645;32865908;744;2965;1424;1541
646;17969077;745;2693;1078;1615
647;32791934;746;2318;1159;1159
648;32971612;747;2827;1188;1639
649;54341;748;1521;761;760
650;32966913;749;2489;1270;1219
651;32944301;750;2865;1347;1518
652;32126448;751;2047;881;1166
653;3592517;752;732;352;380
654;32846763;753;1066;491;575
655;80220254;754;1210;581;629
656;32908145;755;1233;617;616
657;32732565;756;919;432;487
658;32930573;757;1294;622;672
659;32858471;758;1452;726;726
660;32907424;759;1487;699;788
661;31812989;760;544;278;266
662;32842380;761;1340;577;763
663;32796692;762;1360;694;666
664;32929665;763;939;470;469
665;227603;764;1224;612;612
666;32855928;765;1262;568;694
667;32900920;766;891;366;525
668;32910735;767;539;238;301
669;8618440;768;1130;520;610
670;8683194;769;890;445;445
671;32990723;770;762;321;441
672;18720971;771;1464;732;732
673;32904180;772;642;257;385
674;41736405;773;891;375;516
675;43084428;774;800;384;416
676;32980155;775;1326;677;649
677;46277750;776;954;411;543
678;32925726;777;1129;463;666
679;9997131;778;689;297;392
680;32772265;779;2526;1087;1439
681;32865703;780;2695;1294;1401
682;46187525;781;1661;665;996
683;32970591;782;1535;630;905
684;41098651;783;1618;648;970
685;32774310;784;2538;1143;1395
686;42483915;785;681;307;374
687;32813262;786;1405;647;758
688;32814682;787;1229;578;651
689;32960202;788;705;325;380
690;80162917;789;1290;504;786
691;32968824;790;609;268;341
692;32888158;791;1347;674;673
693;32888164;792;1459;657;802
694;16497583;793;1243;535;708
695;43376318;794;824;371;453
696;32838890;795;1457;714;743
697;17971007;796;670;289;381
698;17970465;797;1368;548;820
699;32932380;798;1144;561;583
700;32855980;799;1173;587;586
701;32777624;800;659;330;329
702;32132022;801;1272;573;699
703;32842238;802;783;361;422
704;32765371;803;765;360;405
705;32848665;804;792;341;451
706;32841543;805;1187;558;629
707;46126017;806;1143;458;685
708;70430004;807;973;419;554
709;32845155;808;1153;485;668
710;32840663;809;991;387;604
711;32979945;810;2418;992;1426
712;43838392;811;1577;663;914
713;32855094;812;1705;751;954
714;33260778;813;1797;863;934
715;44410618;814;1741;801;940
716;41497521;815;2109;950;1159
717;70488810;816;1924;770;1154
718;32816100;817;2259;927;1332
719;32804426;818;2605;1147;1458
720;32798575;819;2079;998;1081
721;32826437;820;1695;865;830
722;32979312;821;1617;663;954
723;32822112;822;1962;883;1079
724;32811728;823;2059;865;1194
725;32865575;824;1698;748;950
726;99439745;825;1760;828;932
727;32859252;826;2834;1162;1672
728;32969741;827;1733;850;883
729;32814735;828;2055;1028;1027
730;40740365;829;1772;886;886
731;2812962;830;2122;1040;1082
732;32814736;831;1525;610;915
733;40057937;832;1878;864;1014
734;32916049;833;2299;1127;1172
735;32991307;834;1770;744;1026
736;42488977;835;1640;640;1000
737;32855417;836;1582;697;885
738;32809073;837;2253;1059;1194
739;40507876;838;2127;1043;1084
740;32796937;839;2127;958;1169
741;32790528;840;1547;697;850
742;32843616;841;2474;1089;1385
743;32792145;842;2877;1353;1524
744;32840523;843;1586;778;808
745;32800945;844;1532;690;842
746;32768316;845;2490;1071;1419
747;32956850;846;2943;1207;1736
748;32800839;847;2683;1101;1582
749;32957004;848;2198;968;1230
750;32798676;849;2413;1159;1254
751;32988875;850;2617;1021;1596
752;32885602;851;2825;1130;1695
753;25697697;852;1986;775;1211
754;41261536;853;2189;854;1335
755;32976745;854;2273;1137;1136
756;32138841;855;2871;1465;1406
757;40537053;856;2098;945;1153
758;32855679;857;2967;1306;1661
759;18220852;858;2765;1106;1659
760;32809191;859;2998;1470;1528
761;32798320;860;2054;925;1129
762;43826811;861;2089;878;1211
763;32969592;862;2631;1158;1473
764;32919505;863;3000;1200;1800
765;32922656;864;1553;730;823
766;18214741;865;2372;1092;1280
767;41581842;866;2811;1209;1602
768;32858266;867;1558;670;888
769;32963700;868;1900;931;969
770;32862646;869;1001;511;490
771;32852765;870;1241;609;632
772;32844728;871;1148;540;608
773;32863100;872;1252;626;626
774;32924195;873;1138;513;625
775;46918965;874;935;384;551
776;32931571;875;1137;478;659
777;43407491;876;682;328;354
778;42949482;877;952;467;485
779;32791957;878;697;286;411
780;32843063;879;804;330;474
781;16645226;880;697;328;369
782;32863530;881;616;247;369
783;32986686;882;724;283;441
784;32838534;883;785;385;400
785;43307886;884;1330;599;731
786;32932564;885;589;260;329
787;43697350;886;1256;566;690
788;32912540;887;746;329;417
789;32862839;888;1408;648;760
790;32771762;889;1156;590;566
791;6242022;890;750;300;450
792;32980053;891;1042;521;521
793;32912296;892;575;242;333
794;43372552;893;2503;1027;1476
795;32933439;894;1636;655;981
796;32838987;895;2402;1057;1345
797;32913329;896;2694;1213;1481
798;32797741;897;1157;475;682
799;45154941;898;765;314;451
800;32851093;899;948;380;568
801;21469500;900;1179;566;613
802;2715025;901;998;410;588
803;32922284;902;1007;444;563
804;32942936;903;535;225;310
805;32732693;904;826;389;437
806;32904442;905;1070;428;642
807;32810312;906;621;249;372
808;32972108;907;985;394;591
809;32866545;908;1038;447;591
810;32834722;909;1316;566;750
811;32987604;910;1116;558;558
812;32864204;911;724;290;434
813;32102931;912;800;360;440
814;32950921;913;1419;696;723
815;32911854;914;964;473;491
816;32979777;915;562;242;320
817;32918086;916;853;359;494
818;32905997;917;826;356;470
819;32849039;918;597;245;352
820;31654355;919;947;474;473
821;32866765;920;2298;1104;1194
822;32804027;921;2384;1145;1239
823;32779062;922;2821;1411;1410
824;80251048;923;1814;708;1106
825;32939705;924;2339;1030;1309
826;32849114;925;1975;850;1125
827;32541388;926;2240;1031;1209
828;40813444;927;1601;721;880
829;32789986;928;1865;784;1081
830;10563219;929;1561;797;764
831;32833147;930;2510;1080;1430
832;32982941;931;2723;1090;1633
833;32801657;932;2305;1107;1198
834;32801369;933;2956;1272;1684
835;32862072;934;2340;936;1404
836;32738346;935;2828;1330;1498
837;32909930;936;1767;743;1024
838;32822591;937;2593;1141;1452
839;75156297;938;2083;959;1124
840;60817175;939;2342;1171;1171
841;42725523;940;2416;1160;1256
842;32920622;941;2711;1302;1409
843;42315262;942;1691;795;896
844;46491483;943;2479;1190;1289
845;41608181;944;2503;1127;1376
846;70524112;945;2095;964;1131
847;80621014;946;2951;1387;1564
848;43724305;947;2098;966;1132
849;32981192;948;2521;1009;1512
850;40015457;949;1952;801;1151
851;32937557;950;1835;753;1082
852;32936529;951;2744;1290;1454
853;32902759;952;2749;1320;1429
854;32734192;953;1639;640;999
855;32937741;954;2559;1126;1433
856;32936280;955;1586;793;793
857;32934212;956;1844;922;922
858;32937817;957;1663;666;997
859;90061694;958;2483;969;1514
860;32935305;959;2136;1026;1110
861;32937139;960;2535;1014;1521
862;41469453;961;2331;1166;1165
863;41217954;962;2693;1374;1319
864;32897002;963;2948;1327;1621
865;32734190;964;1508;604;904
866;8934202;965;2444;1174;1270
867;32934988;966;2479;1215;1264
868;32744625;967;2259;1062;1197
869;32935843;968;2494;1173;1321
870;32937103;969;2684;1181;1503
871;32915159;970;2398;1032;1366
872;42998308;971;2093;1047;1046
873;32922575;972;1883;923;960
874;32948824;973;1891;889;1002
875;32937332;974;2470;1137;1333
876;41223562;975;2798;1232;1566
877;8259996;976;2885;1154;1731
878;32936157;977;2745;1126;1619
879;32900902;978;2627;1340;1287
880;32985482;979;2433;1047;1386
881;40327723;980;2672;1043;1629
882;80205914;981;1592;749;843
883;17929329;982;2585;1060;1525
884;32989969;983;1930;772;1158
885;32936612;984;2890;1214;1676
886;44473511;985;2072;829;1243
887;40739131;986;1857;910;947
888;40268807;987;1586;793;793
889;32734019;988;2160;972;1188
890;32938600;989;1424;613;811
891;32985362;990;757;349;408
892;42396097;991;663;319;344
893;32935001;992;963;424;539
894;32934323;993;783;353;430
895;32936138;994;1448;652;796
896;32936573;995;1229;541;688
897;32355553;996;1228;578;650
898;42489620;997;1076;431;645
899;41664046;998;1107;521;586
900;32834406;999;1315;513;802
901;1001507;1000;842;421;421
902;32897441;1001;1174;494;680
903;32902421;1002;961;395;566
904;32902207;1003;1393;572;821
905;32936988;1004;959;442;517
906;40679044;1005;754;317;437
907;32734363;1006;1248;562;686
908;41480628;1007;962;481;481
909;32938439;1008;549;220;329
910;7045105;1009;1348;621;727
911;32937213;1010;1158;533;625
912;32985305;1011;508;239;269
913;40036831;1012;1416;581;835
914;32734285;1013;612;264;348
915;43572143;1014;750;293;457
916;71397663;1015;2628;1236;1392
917;32935828;1016;2104;1010;1094
918;41779756;1017;1579;711;868
919;47322234;1018;1724;742;982
920;32936512;1019;1701;698;1003
921;32909412;1020;1552;637;915
922;46489092;1021;1781;909;872
923;10778784;1022;2313;1134;1179
924;43309246;1023;2056;926;1130
925;32985271;1024;1728;726;1002
926;17853667;1025;1962;942;1020
927;32937537;1026;2255;1128;1127
928;71397665;1027;2454;1007;1447
929;32836275;1028;1563;610;953
930;48074171;1029;2035;835;1200
931;7646880;1030;2904;1336;1568
932;32900457;1031;2566;1130;1436
933;46917324;1032;2708;1111;1597
934;32937235;1033;1967;1004;963
935;32948081;1034;1639;672;967
936;32897922;1035;2711;1248;1463
937;32951408;1036;2173;1109;1064
938;40958782;1037;1819;910;909
939;32829453;1038;2091;983;1108
940;43133555;1039;2240;1120;1120
941;32946471;1040;2159;929;1230
942;32954005;1041;1821;856;965
943;42887109;1042;2585;1034;1551
944;41087091;1043;2619;1205;1414
945;32983172;1044;1663;682;981
946;80281746;1045;1584;808;776
947;32869831;1046;2043;920;1123
948;32541251;1047;2506;1078;1428
949;32953491;1048;1600;800;800
950;32819618;1049;2174;870;1304
951;43359650;1050;2446;1028;1418
952;41742408;1051;1594;638;956
953;32978644;1052;1788;787;1001
954;32965024;1053;1836;753;1083
955;16133993;1054;2014;806;1208
956;32930687;1055;1594;782;812
957;32863199;1056;2225;890;1335
958;32828532;1057;2177;871;1306
959;32854103;1058;2687;1075;1612
960;32858043;1059;1918;787;1131
961;32861387;1060;1042;417;625
962;32823012;1061;1387;597;790
963;32828067;1062;1267;583;684
964;32863284;1063;736;354;382
965;32862993;1064;604;242;362
966;32778784;1065;1205;543;662
967;32914752;1066;1107;432;675
968;32859694;1067;1447;608;839
969;32732463;1068;1317;633;684
970;32846481;1069;1313;631;682
971;32806145;1070;557;285;272
972;32797090;1071;699;273;426
973;32929891;1072;1303;626;677
974;32865668;1073;1214;474;740
975;32795553;1074;1126;563;563
976;32990326;1075;570;251;319
977;42654963;1076;745;336;409
978;32899403;1077;1220;574;646
979;32959804;1078;916;413;503
980;32865518;1079;1472;604;868
981;32836806;1080;899;396;503
982;32786807;1081;958;441;517
983;32808469;1082;982;393;589
984;32968560;1083;644;322;322
985;32930936;1084;1488;759;729
986;40963647;1085;940;470;470
987;32777085;1086;2619;1100;1519
988;33259950;1087;2723;1226;1497
989;32819498;1088;2739;1370;1369
990;32921097;1089;2843;1308;1535
991;32847811;1090;2608;1018;1590
992;32916761;1091;2583;1060;1523
993;32847510;1092;2659;1064;1595
994;16515637;1093;2852;1312;1540
995;32737414;1094;1693;779;914
996;32842480;1095;1996;959;1037
997;40443136;1096;2789;1423;1366
998;8540495;1097;2256;1038;1218
999;32843524;1098;2320;1044;1276
1000;32735370;1099;2523;1212;1311
1001;32781627;1100;2878;1152;1726
1002;32919051;1101;2696;1160;1536
1003;32905481;1102;2880;1440;1440
1004;32968383;1103;2557;1100;1457
1005;32839545;1104;2445;1174;1271
1006;32795059;1105;2167;1041;1126
1007;6437828;1106;1513;727;786
1008;32836082;1107;1797;719;1078
1009;32960225;1108;2641;1163;1478
1010;32784573;1109;1516;698;818
1011;32945522;1110;2168;1019;1149
1012;32977384;1111;2561;1076;1485
1013;32735061;1112;1877;733;1144
1014;32835466;1113;2394;1054;1340
1015;32957127;1114;1572;739;833
1016;16620452;1115;1572;802;770
1017;32801985;1116;2813;1266;1547
1018;32772558;1117;1889;926;963
1019;42034726;1118;1981;773;1208
1020;32823037;1119;2874;1150;1724
1021;41360215;1120;2057;844;1213
1022;32263032;1121;2272;909;1363
1023;32907392;1122;2936;1146;1790
1024;43411507;1123;1351;649;702
1025;33262553;1124;1463;717;746
1026;32963599;1125;652;268;384
1027;32407460;1126;965;435;530
1028;45158177;1127;1054;443;611
1029;45484115;1128;536;215;321
1030;41881836;1129;1424;670;754
1031;2829510;1130;1151;484;667
1032;9641369;1131;779;335;444
1033;46116878;1132;1450;580;870
1034;32799574;1133;1363;587;776
1035;32869043;1134;1150;552;598
1036;41929659;1135;926;445;481
1037;32737085;1136;1465;718;747
1038;40803549;1137;1087;457;630
1039;32888429;1138;890;365;525
1040;73540458;1139;935;374;561
1041;32952525;1140;1221;623;598
1042;42536948;1141;1375;688;687
1043;32927594;1142;1294;544;750
1044;32970728;1143;719;360;359
1045;18114847;1144;1370;603;767
1046;32789650;1145;1308;537;771
1047;46205774;1146;2197;923;1274
1048;47161907;1147;2783;1253;1530
1049;8854586;1148;1577;757;820
1050;32794944;1149;2855;1371;1484
1051;32843388;1150;1936;852;1084
1052;32818154;1151;1765;759;1006
1053;32952263;1152;2327;1117;1210
1054;46416131;1153;2582;1162;1420
1055;33262634;1154;2705;1137;1568
1056;32809309;1155;1293;621;672
1057;76183580;1156;519;208;311
1058;70551653;1157;1245;561;684
1059;32772085;1158;970;379;591
1060;32970785;1159;1419;582;837
1061;70525036;1160;1328;611;717
1062;45623473;1161;1341;604;737
1063;32972590;1162;925;435;490
1064;44642139;1163;1255;515;740
1065;80331783;1164;1268;533;735
1066;32920717;1165;629;302;327
1067;32830087;1166;814;318;496
1068;32794571;1167;913;393;520
1069;41632562;1168;1127;463;664
1070;32733848;1169;560;219;341
1071;47349268;1170;1331;533;798
1072;32845959;1171;1339;643;696
1073;75736122;1172;1186;487;699
1074;32966343;1173;591;296;295
1075;71041945;1174;1366;629;737
1076;62752617;1175;931;382;549
1077;48777665;1176;511;261;250
1078;32905340;1177;1902;951;951
1079;32961979;1178;2189;986;1203
1080;32864764;1179;2085;855;1230
1081;32798365;1180;1884;735;1149
1082;32132186;1181;1639;689;950
1083;32951864;1182;2937;1352;1585
1084;32977672;1183;1500;675;825
1085;18861065;1184;2369;1067;1302
1086;32861137;1185;2133;918;1215
1087;43014448;1186;2404;1178;1226
1088;32951537;1187;2985;1194;1791
1089;32761668;1188;1780;801;979
1090;44158051;1189;1620;665;955
1091;33264399;1190;1929;888;1041
1092;32927592;1191;1633;752;881
1093;42641779;1192;1992;857;1135
1094;44555891;1193;1593;638;955
1095;32887354;1194;2906;1483;1423
1096;32739620;1195;2106;1075;1031
1097;32811054;1196;2511;1105;1406
1098;41601414;1197;2431;1167;1264
1099;18052240;1198;2748;1265;1483
1100;32920412;1199;2454;1031;1423
1101;32887853;1200;1788;769;1019
1102;32860312;1201;2252;879;1373
1103;45098343;1202;2328;1118;1210
1104;32982046;1203;1984;854;1130
1105;32798218;1204;1644;691;953
1106;44237902;1205;2629;1184;1445
1107;32851791;1206;2766;1218;1548
1108;32986951;1207;2217;932;1285
1109;44867501;1208;2344;1102;1242
1110;32762883;1209;1990;777;1213
1111;32953951;1210;2144;901;1243
1112;32828357;1211;2257;903;1354
1113;43147064;1212;1969;827;1142
1114;32904952;1213;2048;1004;1044
1115;32858744;1214;2239;986;1253
1116;32911439;1215;2955;1448;1507
1117;41252546;1216;1940;893;1047
1118;32842965;1217;1606;771;835
1119;33260928;1218;2795;1174;1621
1120;32783592;1219;2417;1161;1256
1121;32937083;1220;2724;1308;1416
1122;32850509;1221;1511;696;815
1123;32959013;1222;2406;963;1443
1124;32927356;1223;2890;1388;1502
1125;45268515;1224;2728;1174;1554
1126;43163563;1225;1806;705;1101
1127;33261272;1226;2362;1087;1275
1128;32776205;1227;2124;1020;1104
1129;32736828;1228;2395;1174;1221
1130;32789564;1229;1589;747;842
1131;32933816;1230;1373;660;713
1132;32542781;1231;588;247;341
1133;42928772;1232;578;226;352
1134;41083110;1233;750;375;375
1135;44688948;1234;514;247;267
1136;32769420;1235;1082;498;584
1137;32850867;1236;726;327;399
1138;32907376;1237;1484;742;742
1139;41217970;1238;1493;687;806
1140;18199079;1239;571;240;331
1141;32781694;1240;1341;537;804
1142;32839224;1241;1195;514;681
1143;32925970;1242;1083;488;595
1144;32804368;1243;630;297;333
1145;32132963;1244;1488;715;773
1146;32960538;1245;1138;467;671
1147;32868758;1246;688;310;378
1148;40110600;1247;1251;551;700
1149;32737162;1248;1418;596;822
1150;32819286;1249;1240;558;682
1151;2151326;1250;871;401;470
1152;32842841;1251;1143;469;674
1153;32840486;1252;1301;599;702
1154;32927992;1253;651;313;338
1155;32869100;1254;2230;1026;1204
1156;32834134;1255;2559;1024;1535
1157;32785021;1256;2553;1149;1404
1158;32779843;1257;1837;901;936
1159;32825550;1258;2821;1270;1551
1160;32816399;1259;2037;836;1201
1161;32983298;1260;2376;1117;1259
1162;32790213;1261;2069;911;1158
1163;6928747;1262;2000;940;1060
1164;18032944;1263;2210;907;1303
1165;32739855;1264;2412;1038;1374
1166;32789671;1265;2850;1311;1539
1167;32957801;1266;1925;770;1155
1168;32821074;1267;2079;915;1164
1169;32929556;1268;2008;1004;1004
1170;41190205;1269;1679;790;889
1171;32925285;1270;2745;1181;1564
1172;32828435;1271;2070;891;1179
1173;32830076;1272;1413;594;819
1174;32914861;1273;581;291;290
1175;44472262;1274;816;343;473
1176;45774762;1275;1155;509;646
1177;46544975;1276;1000;390;610
1178;45391504;1277;1045;533;512
1179;80388118;1278;608;250;358
1180;32738159;1279;500;205;295
1181;44505201;1280;624;294;330
1182;32835150;1281;1482;608;874
1183;32799995;1282;1095;537;558
1184;32898177;1283;1292;569;723
1185;32934602;1284;540;222;318
1186;32935178;1285;543;245;298
1187;32934271;1286;1451;726;725
1188;32938454;1287;626;307;319
1189;32734378;1288;1133;556;577
1190;32935924;1289;1481;756;725
1191;17919453;1290;1044;502;542
1192;32896060;1291;1067;470;597
1193;32937002;1292;1109;533;576
1194;32937464;1293;591;284;307
1195;32934431;1294;964;386;578
1196;32900729;1295;1347;553;794
1197;32937248;1296;2141;1050;1091
1198;32863191;1297;2736;1314;1422
1199;32985533;1298;1900;817;1083
1200;40826492;1299;2809;1293;1516
1201;32936256;1300;2743;1125;1618
1202;32934239;1301;2265;1110;1155
1203;41139808;1302;1963;923;1040
1204;32890350;1303;2674;1070;1604
1205;32937203;1304;2506;1103;1403
1206;40327706;1305;2137;834;1303
1207;32543060;1306;2726;1091;1635
1208;32947810;1307;2505;1203;1302
1209;41596342;1308;1687;861;826
1210;32891435;1309;2436;1121;1315
1211;32971775;1310;2557;1049;1508
1212;32949488;1311;2561;1127;1434
1213;32936028;1312;2701;1081;1620
1214;41778679;1313;1723;690;1033
1215;40256433;1314;1523;686;837
1216;45670126;1315;1361;627;734
1217;32935492;1316;1016;417;599
1218;32935932;1317;608;298;310
1219;32833134;1318;783;329;454
1220;32936561;1319;1125;552;573
1221;32964385;1320;1137;580;557
1222;32934185;1321;1333;680;653
1223;32948379;1322;787;315;472
1224;32948640;1323;1445;709;736
1225;32937003;1324;919;442;477
1226;32734123;1325;600;264;336
1227;32875941;1326;562;259;303
1228;32875811;1327;929;428;501
1229;32936403;1328;1229;492;737
1230;32936492;1329;666;307;359
1231;32934202;1330;783;337;446
1232;45032218;1331;1087;457;630
1233;48385009;1332;994;468;526
1234;40518596;1333;871;349;522
1235;73479888;1334;608;256;352
1236;40095020;1335;1151;518;633
1237;40382053;1336;1373;673;700
1238;32922645;1337;2740;1288;1452
1239;44791116;1338;1265;532;733
1240;41180029;1339;1487;670;817
1241;40507510;1340;1316;553;763
1242;32975185;1341;1104;464;640
1243;32817884;1342;901;424;477
1244;32916286;1343;1113;490;623
1245;32866489;1344;638;249;389
1246;7516733;1345;989;505;484
1247;32768399;1346;1117;514;603
1248;32940445;1347;1077;517;560
1249;32790110;1348;1436;618;818
1250;32923242;1349;1071;482;589
1251;41372219;1350;662;305;357
1252;42045149;1351;566;227;339
1253;43150315;1352;1315;553;762
1254;41732399;1353;937;413;524
1255;42412659;1354;502;221;281
1256;42292558;1355;1245;548;697
1257;32790048;1356;946;436;510
1258;32981806;1357;1182;509;673
1259;32823156;1358;1268;584;684
1260;32979554;1359;884;389;495
1261;32857648;1360;539;270;269
1262;32945202;1361;1613;791;822
1263;45029041;1362;2575;1030;1545
1264;40020482;1363;2833;1219;1614
1265;43885362;1364;1566;674;892
1266;80251411;1365;2752;1321;1431
1267;40779432;1366;2277;911;1366
1268;32807511;1367;1663;799;864
1269;46957244;1368;2351;1011;1340
1270;46662903;1369;2810;1181;1629
1271;32957515;1370;2684;1342;1342
1272;42821199;1371;2241;897;1344
1273;32907565;1372;2037;938;1099
1274;32932315;1373;2666;1333;1333
1275;32929919;1374;1951;917;1034
1276;32981719;1375;1726;743;983
1277;40342726;1376;1922;923;999
1278;80194561;1377;2258;904;1354
1279;32810576;1378;2399;1032;1367
1280;8968577;1379;2451;981;1470
1281;45370320;1380;1530;689;841
1282;32785235;1381;1985;894;1091
1283;44332361;1382;2538;1168;1370
1284;33676336;1383;2176;958;1218
1285;44004608;1384;2431;1094;1337
1286;46152029;1385;2821;1411;1410
1287;44997729;1386;1904;838;1066
1288;40754930;1387;2960;1244;1716
1289;32909085;1388;2573;1055;1518
1290;3650904;1389;2144;1051;1093
1291;32785148;1390;2856;1314;1542
1292;40527668;1391;1646;791;855
1293;32887850;1392;860;396;464
1294;41438703;1393;1295;544;751
1295;32776928;1394;1462;600;862
1296;32823024;1395;1295;531;764
1297;32932712;1396;709;277;432
1298;19084129;1397;582;251;331
1299;47702905;1398;1403;562;841
1300;44661582;1399;1463;630;833
1301;32764147;1400;1292;556;736
1302;44201836;1401;1236;606;630
1303;48740823;1402;1204;590;614
1304;32965936;1403;1401;673;728
1305;48498647;1404;1195;598;597
1306;41929176;1405;1295;557;738
1307;71477121;1406;1404;632;772
1308;45728281;1407;941;443;498
1309;46577836;1408;890;419;471
1310;41639289;1409;905;381;524
1311;70180787;1410;1105;487;618
1312;48363578;1411;530;265;265
1313;32959032;1412;1108;554;554
1314;32961102;1413;860;439;421
1315;32907422;1414;753;377;376
1316;32786140;1415;1040;500;540
1317;74465536;1416;634;298;336
1318;32956785;1417;1326;610;716
1319;32931238;1418;658;336;322
1320;32990536;1419;1084;521;563
1321;30182352;1420;916;440;476
1322;32830669;1421;1354;596;758
1323;32914326;1422;1461;702;759
1324;32955924;1423;1407;591;816
1325;32833877;1424;559;274;285
1326;32839705;1425;1238;496;742
1327;41652628;1426;1131;577;554
1328;40639688;1427;1019;418;601
1329;32806638;1428;678;272;406
1330;32932972;1429;898;369;529
1331;32732706;1430;777;311;466
1332;32983494;1431;703;345;358
1333;7248780;1432;673;337;336
1334;32959031;1433;642;289;353
1335;41941388;1434;612;282;330
1336;40088752;1435;754;302;452
1337;33260770;1436;653;268;385
1338;32917408;1437;1233;506;727
1339;32945470;1438;839;420;419
1340;32736662;1439;1023;471;552
1341;32916027;1440;1023;481;542
1342;32760265;1441;833;425;408
1343;32966041;1442;1472;678;794
1344;32869813;1443;853;410;443
1345;32851557;1444;1024;420;604
1346;32794951;1445;1497;689;808
1347;80260610;1446;1096;538;558
1348;32953672;1447;669;281;388
1349;32766813;1448;518;208;310
1350;45212721;1449;553;266;287
1351;32959095;1450;758;379;379
1352;33260133;1451;600;246;354
1353;40349642;1452;887;417;470
1354;33258507;1453;1270;534;736
1355;10566011;1454;1438;576;862
1356;42654990;1455;1039;499;540
1357;43242967;1456;776;342;434
1358;70859641;1457;899;387;512
1359;41590290;1458;1122;539;583
1360;6226369;1459;663;332;331
1361;47700315;1460;631;310;321
1362;73312824;1461;1286;579;707
1363;32919072;1462;731;359;372
1364;43571867;1463;1425;585;840
1365;43961423;1464;1444;578;866
1366;72209390;1465;706;283;423
1367;74325217;1466;633;279;354
1368;32774284;1467;639;314;325
1369;40551035;1468;1135;523;612
1370;42518378;1469;1310;577;733
1371;32821678;1470;727;357;370
1372;32770971;1471;1335;548;787
1373;45640881;1472;1169;573;596
1374;40437557;1473;1069;439;630
1375;32803278;1474;1327;664;663
1376;41579335;1475;573;264;309
1377;46353815;1476;1245;611;634
1378;41061794;1477;793;373;420
1379;75421291;1478;1418;582;836
1380;32844152;1479;1395;614;781
1381;17869427;1480;1256;541;715
1382;17860100;1481;770;370;400
1383;32803598;1482;916;449;467
1384;32873078;1483;1143;526;617
1385;32867781;1484;1403;590;813
1386;32797988;1485;1289;529;760
1387;32826625;1486;1313;644;669
1388;32933453;1487;902;370;532
1389;32932451;1488;635;261;374
1390;32822881;1489;750;315;435
1391;32803761;1490;944;463;481
1392;33261598;1491;639;307;332
1393;17871594;1492;979;402;577
1394;32733572;1493;1231;604;627
1395;32966045;1494;527;238;289
1396;32847714;1495;661;331;330
1397;32989131;1496;665;273;392
1398;32929151;1497;761;358;403
1399;42489634;1498;1106;476;630
1400;32787341;1499;1336;548;788
1401;32804073;1500;520;250;270
1402;40762724;1501;797;399;398
1403;40181977;1502;1005;483;522
1404;32922646;1503;1405;605;800
1405;32765556;1504;1136;512;624
1406;32839387;1505;814;399;415
1407;32920331;1506;1097;516;581
1408;32990771;1507;1389;695;694
1409;32789594;1508;1453;669;784
1410;32733381;1509;1392;696;696
1411;43036270;1510;931;419;512
1412;32943234;1511;886;373;513
1413;32966650;1512;502;201;301
1414;32922870;1513;775;396;379
1415;32915732;1514;1207;604;603
1416;32941900;1515;524;210;314
1417;40740377;1516;1449;682;767
1418;32868356;1517;844;347;497
1419;80306627;1518;1201;505;696
1420;82957381;1519;1354;556;798
1421;32854401;1520;1362;573;789
1422;32975627;1521;1318;528;790
1423;32933389;1522;1378;689;689
1424;32969954;1523;998;499;499
1425;32904085;1524;1155;555;600
1426;32770880;1525;548;264;284
1427;80621382;1526;1225;478;747
1428;32788517;1527;541;211;330
1429;80206628;1528;1442;606;836
1430;32789226;1529;1152;473;679
1431;40843467;1530;1466;719;747
1432;32915473;1531;1459;628;831
1433;32853791;1532;1199;480;719
1434;32840075;1533;634;317;317
1435;40102322;1534;776;342;434
1436;40191484;1535;1100;462;638
1437;40590729;1536;753;339;414
1438;32723768;1537;1328;625;703
1439;41004712;1538;641;308;333
1440;18118026;1539;892;402;490
1441;40029488;1540;1234;568;666
1442;42026773;1541;1418;639;779
1443;45289413;1542;996;459;537
1444;42768771;1543;1475;664;811
1445;32982964;1544;1316;645;671
1446;32863041;1545;1380;566;814
1447;32924563;1546;619;254;365
1448;32949106;1547;538;269;269
1449;43288413;1548;653;294;359
1450;32959899;1549;735;346;389
1451;40181576;1550;672;336;336
1452;32940235;1551;1202;481;721
1453;32930277;1552;793;397;396
1454;33265199;1553;1469;617;852
1455;33265525;1554;899;378;521
1456;80256416;1555;1439;691;748
1457;32736333;1556;1245;511;734
1458;32732576;1557;1242;547;695
1459;32735703;1558;605;261;344
1460;32959297;1559;1113;535;578
1461;32918657;1560;1337;682;655
1462;40518881;1561;956;392;564
1463;32888780;1562;1346;660;686
1464;32946522;1563;756;371;385
1465;32860771;1564;665;273;392
1466;32776800;1565;815;400;415
1467;32820386;1566;987;455;532
1468;32973163;1567;1398;699;699
1469;32979580;1568;1019;510;509
1470;32953202;1569;1279;589;690
1471;32924167;1570;1062;510;552
1472;32852235;1571;1477;665;812
1473;32848927;1572;1443;607;836
1474;32865525;1573;612;264;348
1475;32832579;1574;1335;615;720
1476;16010712;1575;1155;532;623
1477;32793191;1576;1055;507;548
1478;32901684;1577;1021;409;612
1479;32869982;1578;955;440;515
1480;43411517;1579;1043;522;521
1481;32737765;1580;536;220;316
1482;32842963;1581;1179;566;613
1483;32970433;1582;602;289;313
1484;32861800;1583;1491;731;760
1485;32843895;1584;1265;532;733
1486;40551032;1585;1483;727;756
1487;32957630;1586;1213;510;703
1488;32977625;1587;1441;591;850
1489;32948478;1588;775;341;434
1490;3869655;1589;837;344;493
1491;32770690;1590;761;320;441
1492;41411134;1591;1132;544;588
1493;32958570;1592;941;471;470
1494;41335012;1593;1170;539;631
1495;32832561;1594;1108;455;653
1496;32736783;1595;728;314;414
1497;32739514;1596;952;457;495
1498;43148645;1597;1177;530;647
1499;43047604;1598;526;269;257
1500;32818001;1599;1458;569;889
1501;32959103;1600;1230;492;738
1502;32866846;1601;825;396;429
1503;32788188;1602;759;312;447
1504;32865251;1603;581;268;313
1505;32856697;1604;1421;612;809
1506;70537370;1605;1285;643;642
1507;32908315;1606;1160;534;626
1508;32919117;1607;1406;563;843
1509;32323232;1608;622;262;360
1510;40075462;1609;552;232;320
1511;73079827;1610;561;225;336
1512;23187370;1611;1223;624;599
1513;32832618;1612;1349;662;687
1514;32778016;1613;623;312;311
1515;6210564;1614;561;270;291
1516;32913420;1615;616;296;320
1517;32803623;1616;979;480;499
1518;32833637;1617;1142;480;662
1519;32799666;1618;746;329;417
1520;35952882;1619;1221;489;732
1521;32776041;1620;591;255;336
1522;32778967;1621;1276;562;714
1523;32803292;1622;1276;626;650
1524;32839247;1623;1142;549;593
1525;32789748;1624;1094;427;667
1526;32911476;1625;870;409;461
1527;32924744;1626;1085;424;661
1528;40469897;1627;1146;539;607
1529;32798535;1628;655;328;327
1530;32842017;1629;1156;509;647
1531;32923792;1630;1005;443;562
1532;32795589;1631;817;409;408
1533;32916099;1632;962;405;557
1534;32844058;1633;1377;579;798
1535;32803291;1634;1182;509;673
1536;41529621;1635;1008;424;584
1537;32936591;1636;733;352;381
1538;32957955;1637;746;336;410
1539;41563047;1638;1248;637;611
1540;3223222;1639;768;377;391
1541;80622330;1640;585;246;339
1542;32847324;1641;787;370;417
1543;41122790;1642;692;284;408
1544;32851532;1643;1218;549;669
1545;32940027;1644;1017;438;579
1546;32933866;1645;889;365;524
1547;32816303;1646;842;388;454
1548;43753651;1647;1500;705;795
1549;32828465;1648;1031;485;546
1550;32909429;1649;1154;497;657
1551;80201696;1650;710;363;347
1552;32991531;1651;614;277;337
1553;32842688;1652;672;330;342
1554;32795371;1653;1246;561;685
1555;32923504;1654;803;386;417
1556;32905037;1655;1092;514;578
1557;32958857;1656;503;202;301
1558;40546304;1657;1103;497;606
1559;32889937;1658;760;304;456
1560;8088527;1659;988;396;592
1561;32804838;1660;1191;525;666
1562;41273433;1661;1253;564;689
1563;33260401;1662;1289;542;747
1564;32773703;1663;993;477;516
1565;45620323;1664;978;401;577
1566;43845942;1665;1313;578;735
1567;47668482;1666;1078;475;603
1568;32974239;1667;1479;607;872
1569;32982791;1668;1380;635;745
1570;70187690;1669;608;298;310
1571;32853136;1670;687;282;405
1572;32955801;1671;1308;589;719
1573;32953784;1672;958;412;546
1574;42847280;1673;1466;602;864
1575;42900347;1674;1475;605;870
1576;46945635;1675;1245;635;610
1577;40779170;1676;966;416;550
1578;46809905;1677;691;318;373
1579;43045165;1678;1359;558;801
1580;46816582;1679;1454;568;886
1581;32789303;1680;1330;612;718
1582;43494497;1681;1229;554;675
1583;45459167;1682;821;329;492
1584;32760273;1683;600;246;354
1585;44860823;1684;969;485;484
1586;32980518;1685;895;412;483
1587;42483685;1686;859;353;506
1588;18209111;1687;1222;538;684
1589;6461980;1688;1309;655;654
1590;45640631;1689;998;450;548
1591;44606898;1690;685;336;349
1592;47357269;1691;1319;647;672
1593;41589179;1692;1250;550;700
1594;18173955;1693;888;373;515
1595;32911269;1694;1161;558;603
1596;46682162;1695;898;396;502
1597;43674564;1696;1095;537;558
1598;32739044;1697;932;373;559
1599;45437199;1698;558;235;323
1600;32763203;1699;1195;550;645
1601;47490706;1700;930;475;455
1602;32774386;1701;1352;541;811
1603;70141528;1702;1440;648;792
1604;41128718;1703;1340;657;683
1605;70989297;1704;1336;522;814
1606;45814813;1705;819;336;483
1607;40551037;1706;1491;686;805
1608;43593371;1707;936;431;505
1609;42163273;1708;1460;687;773
1610;70993809;1709;587;288;299
1611;32801340;1710;666;340;326
1612;32955142;1711;1004;432;572
1613;32826869;1712;985;414;571
1614;32979587;1713;543;229;314
1615;32971053;1714;1370;548;822
1616;25440412;1715;1115;491;624
1617;32909820;1716;1213;498;715
1618;32820549;1717;704;296;408
1619;42944250;1718;647;279;368
1620;32955984;1719;512;241;271
1621;32918566;1720;1134;567;567
1622;32805763;1721;1211;545;666
1623;32955913;1722;1250;575;675
1624;32737763;1723;752;309;443
1625;32858773;1724;661;311;350
1626;32857600;1725;691;339;352
1627;32786930;1726;1442;707;735
1628;32887050;1727;1022;491;531
1629;32955584;1728;593;244;349
1630;32821092;1729;1238;632;606
1631;32736251;1730;836;327;509
1632;45450472;1731;1388;570;818
1633;32104049;1732;610;251;359
1634;84926933;1733;1462;673;789
1635;32826500;1734;1466;690;776
1636;32739285;1735;600;264;336
1637;32834766;1736;1082;444;638
1638;32739668;1737;984;453;531
1639;32941498;1738;1465;689;776
1640;32912004;1739;1274;599;675
1641;2677009;1740;851;409;442
1642;32954764;1741;1255;615;640
1643;25898887;1742;975;390;585
1644;32103526;1743;1289;568;721
1645;41783371;1744;1334;534;800
1646;44995566;1745;893;429;464
1647;32944575;1746;1187;463;724
1648;32904718;1747;1119;470;649
1649;32783482;1748;1109;455;654
1650;32911024;1749;1315;540;775
1651;32765572;1750;1458;671;787
1652;32806052;1751;1179;507;672
1653;32799195;1752;1206;591;615
1654;32803096;1753;1046;513;533
1655;32932988;1754;637;300;337
1656;32867226;1755;1149;460;689
1657;32738730;1756;1388;583;805
1658;32985766;1757;614;283;331
1659;32138815;1758;793;405;388
1660;32867247;1759;553;266;287
1661;32836524;1760;539;227;312
1662;32139452;1761;612;300;312
1663;32865167;1762;1420;682;738
1664;32857511;1763;1015;518;497
1665;25879534;1764;831;399;432
1666;32843660;1765;1029;464;565
1667;42580544;1766;834;426;408
1668;32829953;1767;975;420;555
1669;32796357;1768;1385;554;831
1670;80192433;1769;711;285;426
1671;32737402;1770;585;299;286
1672;41920954;1771;1459;715;744
1673;32852693;1772;660;297;363
1674;32974017;1773;1287;528;759
1675;32967551;1774;1412;608;804
1676;44074847;1775;1317;580;737
1677;32796679;1776;1240;484;756
1678;44857374;1777;1243;510;733
1679;40288571;1778;598;288;310
1680;32782319;1779;1274;612;662
1681;80180723;1780;999;470;529
1682;43728560;1781;1167;572;595
1683;80500927;1782;1207;568;639
1684;43817352;1783;623;281;342
1685;44072995;1784;1032;496;536
1686;40244693;1785;1172;528;644
1687;41821591;1786;1250;525;725
1688;32848263;1787;633;254;379
1689;32777106;1788;1233;518;715
1690;41490763;1789;704;303;401
1691;32931892;1790;1255;540;715
1692;32972804;1791;1189;595;594
1693;46435278;1792;583;298;285
1694;41247283;1793;1018;509;509
1695;32779482;1794;736;361;375
1696;32842086;1795;1164;466;698
1697;37373358;1796;643;264;379
1698;43753966;1797;865;433;432
1699;32986571;1798;889;401;488
1700;42867765;1799;968;417;551
1701;32775378;1800;764;352;412
1702;48075070;1801;888;400;488
1703;46760853;1802;1365;587;778
1704;40175202;1803;896;395;501
1705;43708456;1804;1117;559;558
1706;80205509;1805;957;469;488
1707;32876812;1806;1491;761;730
1708;32817538;1807;1298;546;752
1709;46325090;1808;1302;560;742
1710;32944723;1809;620;248;372
1711;32865567;1810;507;249;258
1712;65169727;1811;1405;548;857
1713;70143248;1812;894;421;473
1714;80365985;1813;1182;521;661
1715;75309441;1814;739;333;406
1716;76284215;1815;1112;501;611
1717;70557032;1816;1226;552;674
1718;43870879;1817;1028;412;616
1719;45873574;1818;596;293;303
1720;32896302;1819;1447;724;723
1721;32975272;1820;1298;637;661
1722;44189477;1821;2008;944;1064
1723;32841864;1822;1801;847;954
1724;8730938;1823;1710;838;872
1725;32951199;1824;1773;692;1081
1726;32842249;1825;1558;686;872
1727;32869432;1826;2004;782;1222
1728;32858823;1827;1999;980;1019
1729;32841916;1828;1765;759;1006
1730;32953898;1829;1822;766;1056
1731;33264167;1830;2194;900;1294
1732;32923123;1831;2131;832;1299
1733;32958534;1832;1868;841;1027
1734;32817891;1833;2700;1134;1566
1735;32850184;1834;1800;702;1098
1736;32851291;1835;2571;1312;1259
1737;32983175;1836;2088;836;1252
1738;40698318;1837;2126;957;1169
1739;32873142;1838;2521;1110;1411
1740;32876301;1839;2735;1231;1504
1741;32951613;1840;502;196;306
1742;32953815;1841;1063;436;627
1743;19243679;1842;1231;591;640
1744;32983170;1843;1226;491;735
1745;32926728;1844;1158;579;579
1746;18051516;1845;1464;645;819
1747;32814518;1846;940;386;554
1748;8171066;1847;1258;617;641
1749;32904209;1848;1133;567;566
1750;25546521;1849;1137;535;602
1751;32949478;1850;1207;580;627
1752;80206604;1851;1176;483;693
1753;32953740;1852;1059;530;529
1754;32843344;1853;826;339;487
1755;32817892;1854;816;392;424
1756;42788027;1855;875;447;428
1757;41623717;1856;1318;646;672
1758;32736395;1857;1222;624;598
1759;32139014;1858;847;416;431
1760;32541559;1859;1426;614;812
1761;32959688;1860;1277;537;740
1762;32978911;1861;858;369;489
1763;40208995;1862;712;321;391
1764;32824767;1863;828;381;447
1765;95050166;1864;1260;618;642
1766;32848635;1865;1034;517;517
1767;32909693;1866;580;273;307
1768;32958271;1867;754;310;444
1769;32831949;1868;1385;651;734
1770;10036407;1869;725;319;406
1771;9469383;1870;1193;490;703
1772;41905069;1871;1341;577;764
1773;32954588;1872;1136;523;613
1774;32985785;1873;980;412;568
1775;42871066;1874;1272;624;648
1776;32978043;1875;1468;734;734
1777;93195660;1876;1253;514;739
1778;32975541;1877;598;270;328
1779;32977390;1878;1008;404;604
1780;41819973;1879;1190;595;595
1781;40717234;1880;531;261;270
1782;32957698;1881;1335;681;654
1783;7341446;1882;659;290;369
1784;42624933;1883;796;319;477
1785;10214076;1884;988;455;533
1786;40197467;1885;1374;591;783
1787;76855044;1886;575;282;293
1788;45944433;1887;587;241;346
1789;45640648;1888;583;263;320
1790;30093167;1889;1487;685;802
1791;42487619;1890;1415;666;749
1792;32542098;1891;1479;592;887
1793;32988382;1892;1277;511;766
1794;32952732;1893;747;307;440
1795;44882608;1894;843;380;463
1796;252151;1895;1109;544;565
1797;25841522;1896;831;424;407
1798;9640888;1897;1160;464;696
1799;32770977;1898;608;286;322
1800;45640883;1899;989;446;543
1801;43339333;1900;1484;579;905
1802;8372656;1901;932;466;466
1803;32783955;1902;914;403;511
1804;32763360;1903;1271;547;724
1805;32976540;1904;758;372;386
1806;32821631;1905;1498;585;913
1807;32892608;1906;1295;648;647
1808;32987720;1907;1477;695;782
1809;32972343;1908;1238;582;656
1810;32848125;1909;810;333;477
1811;8110762;1910;670;309;361
1812;32894551;1911;1244;560;684
1813;6797805;1912;1175;553;622
1814;18868891;1913;1180;520;660
1815;41109913;1914;1290;516;774
1816;8029386;1915;681;341;340
1817;74973932;1916;1147;563;584
1818;32978356;1917;1248;487;761
1819;32831168;1918;1338;669;669
1820;32831921;1919;1431;687;744
1821;32963891;1920;1086;446;640
1822;32956218;1921;822;395;427
1823;32925447;1922;766;361;405
1824;80274509;1923;641;276;365
1825;32766232;1924;644;322;322
1826;32864391;1925;1412;706;706
1827;32981972;1926;1191;501;690
1828;32926661;1927;932;420;512
1829;32977846;1928;957;489;468
1830;33264894;1929;524;215;309
1831;32972649;1930;955;440;515
1832;32913248;1931;1369;575;794
1833;32945290;1932;1040;500;540
1834;32914897;1933;1087;446;641
1835;7450632;1934;663;286;377
1836;56504524;1935;1231;591;640
1837;3212300;1936;1064;437;627
1838;32813076;1937;643;277;366
1839;72462208;1938;628;271;357
1840;41305946;1939;1410;691;719
1841;2624501;1940;970;379;591
1842;61361435;1941;1150;529;621
1843;3829017;1942;656;302;354
1844;32842033;1943;1040;448;592
1845;32814046;1944;783;337;446
1846;43531013;1945;859;370;489
1847;41626354;1946;688;317;371
1848;41432260;1947;1419;596;823
1849;32965824;1948;715;351;364
1850;40883857;1949;994;438;556
1851;96010226;1950;551;221;330
1852;32846751;1951;1256;566;690
1853;32917129;1952;791;341;450
1854;67866081;1953;1011;476;535
1855;32811198;1954;1405;562;843
1856;38795135;1955;1481;667;814
1857;32937661;1956;1042;417;625
1858;32958987;1957;555;228;327
1859;32855038;1958;1325;544;781
1860;32956500;1959;632;279;353
1861;32949987;1960;591;290;301
1862;32809866;1961;1197;551;646
1863;32739232;1962;813;342;471
1864;1021709;1963;1392;585;807
1865;32932435;1964;662;318;344
1866;43083954;1965;646;298;348
1867;80561955;1966;907;445;462
1868;32888486;1967;1168;479;689
1869;33261401;1968;1025;451;574
1870;42420633;1969;1158;522;636
1871;40048171;1970;722;297;425
1872;44800855;1971;995;508;487
1873;43771177;1972;682;335;347
1874;32978328;1973;830;407;423
1875;42864833;1974;778;374;404
1876;32795258;1975;660;324;336
1877;36382772;1976;1456;597;859
1878;32895195;1977;902;406;496
1879;32978418;1978;1236;581;655
1880;41715043;1979;918;450;468
1881;42900354;1980;654;334;320
1882;43081831;1981;1162;570;592
1883;53098937;1982;1298;624;674
1884;32908866;1983;1074;495;579
1885;19195726;1984;567;256;311
1886;41183067;1985;1042;469;573
1887;41002325;1986;578;255;323
1888;43182325;1987;679;306;373
1889;26807759;1988;1078;432;646
1890;45823691;1989;965;406;559
1891;32541121;1990;1391;640;751
1892;32983869;1991;1143;572;571
1893;40502213;1992;1099;506;593
1894;42026782;1993;1068;492;576
1895;46084210;1994;590;236;354
1896;43554696;1995;1176;565;611
1897;32541822;1996;822;395;427
1898;32768253;1997;905;462;443
1899;27829779;1998;774;387;387
1900;32855719;1999;605;279;326
1901;40959238;2000;1143;492;651
1902;32542956;2001;1419;582;837
1903;32992265;2002;1457;685;772
1904;44072320;2003;1323;609;714
1905;32935071;2004;1328;611;717
1906;17542949;2005;795;390;405
1907;41861933;2006;952;448;504
1908;41736983;2007;920;460;460
1909;32986292;2008;949;418;531
1910;3577286;2009;965;473;492
1911;32956088;2010;1276;587;689
1912;19249991;2011;1139;536;603
1913;36877154;2012;1039;468;571
1914;32826956;2013;1208;604;604
1915;32739681;2014;1079;421;658
1916;47534086;2015;1388;597;791
1917;32979212;2016;1183;521;662
1918;47483638;2017;1341;604;737
1919;12415367;2018;627;295;332
1920;40208802;2019;1138;501;637
1921;70553950;2020;1161;546;615
1922;32859742;2021;723;290;433
1923;32766288;2022;987;494;493
1924;32736966;2023;591;237;354
1925;70003950;2024;541;244;297
1926;3577285;2025;1251;551;700
1927;46477018;2026;965;473;492
1928;32929529;2027;1435;675;760
1929;40871832;2028;1329;638;691
1930;32957916;2029;1316;672;644
1931;32915787;2030;1258;604;654
1932;32863245;2031;1158;533;625
1933;32929233;2032;704;338;366
1934;32865659;2033;1274;625;649
1935;32969434;2034;1116;447;669
1936;32910310;2035;1289;516;773
1937;32805476;2036;1457;729;728
1938;32806332;2037;1397;587;810
1939;43150757;2038;987;435;552
1940;32929406;2039;1274;497;777
1941;32940444;2040;772;363;409
1942;43136029;2041;1187;523;664
1943;32807324;2042;1486;580;906
1944;32961575;2043;1216;536;680
1945;41351983;2044;737;332;405
1946;32844155;2045;1123;562;561
1947;41925940;2046;1390;654;736
1948;40058344;2047;1166;549;617
1949;32916047;2048;1365;642;723
1950;41182585;2049;1032;475;557
1951;43515623;2050;954;449;505
1952;41530565;2051;699;294;405
1953;32964284;2052;697;286;411
1954;32812555;2053;763;329;434
1955;42475020;2054;535;231;304
1956;42451043;2055;1263;619;644
1957;32737303;2056;1376;633;743
1958;40591207;2057;1147;528;619
1959;42787424;2058;1011;455;556
1960;44824537;2059;1100;440;660
1961;18547112;2060;1282;590;692
1962;32930745;2061;792;365;427
1963;32942755;2062;974;429;545
1964;32894117;2063;1292;504;788
1965;32899607;2064;631;316;315
1966;41349170;2065;600;240;360
1967;32902731;2066;1423;641;782
1968;32897654;2067;687;317;370
1969;32038116;2068;1476;738;738
1970;32966341;2069;1374;674;700
1971;17909627;2070;772;371;401
1972;32853864;2071;698;343;355
1973;32946678;2072;681;266;415
1974;32894311;2073;1268;609;659
1975;32916352;2074;574;276;298
1976;42609730;2075;1495;733;762
1977;41706278;2076;1187;535;652
1978;32801884;2077;678;339;339
1979;32891459;2078;951;419;532
1980;40165160;2079;1053;527;526
1981;32400578;2080;674;263;411
1982;32900859;2081;1119;470;649
1983;32899109;2082;521;245;276
1984;42575626;2083;1381;594;787
1985;32826246;2084;1013;466;547
1986;32920774;2085;826;380;446
1987;32893763;2086;860;422;438
1988;32946857;2087;1088;523;565
1989;32899919;2088;1346;647;699
1990;32891452;2089;923;388;535
1991;80193569;2090;1004;422;582
1992;40749560;2091;638;262;376
1993;32872946;2092;610;281;329
1994;32947362;2093;565;289;276
1995;41418197;2094;821;329;492
1996;32946299;2095;1250;538;712
1997;32734563;2096;1013;406;607
1998;32896119;2097;539;275;264
1999;32853090;2098;1441;721;720
2000;32891390;2099;636;287;349
2001;32892923;2100;660;297;363
2002;40892162;2101;1444;650;794
2003;32859688;2102;620;255;365
2004;42416475;2103;738;310;428
2005;32966991;2104;531;250;281
2006;43057823;2105;1177;518;659
2007;40547850;2106;1075;549;526
2008;32946076;2107;1373;563;810
2009;32901689;2108;1380;608;772
2010;43299335;2109;1202;614;588
2011;42124350;2110;1079;475;604
2012;43736128;2111;1260;517;743
2013;41020288;2112;1332;666;666
2014;32900694;2113;787;315;472
2015;32890346;2114;558;246;312
2016;32895207;2115;972;380;592
2017;45224096;2116;859;336;523
2018;32896078;2117;1287;644;643
2019;32947571;2118;525;237;288
2020;42572289;2119;1455;597;858
2021;42265226;2120;816;408;408
2022;32984358;2121;559;263;296
2023;40307422;2122;626;263;363
2024;47174853;2123;1469;662;807
2025;41589194;2124;1128;463;665
2026;40025301;2125;1280;615;665
2027;41092752;2126;1403;632;771
2028;32898488;2127;790;309;481
2029;44158024;2128;806;347;459
2030;32897553;2129;1473;634;839
2031;32946539;2130;1047;451;596
2032;10724706;2131;653;275;378
2033;32992614;2132;566;261;305
2034;46906124;2133;589;248;341
2035;32928722;2134;859;353;506
2036;47387256;2135;1446;637;809
2037;32891505;2136;622;318;304
2038;32854873;2137;704;338;366
2039;32899628;2138;1467;631;836
2040;43995200;2139;1145;573;572
2041;43000865;2140;1098;528;570
2042;32899820;2141;831;416;415
2043;32899217;2142;822;329;493
2044;32902467;2143;1391;668;723
2045;70763758;2144;637;255;382
2046;32838725;2145;1194;550;644
2047;9613547;2146;1215;486;729
2048;32909231;2147;691;277;414
2049;3879745;2148;1243;535;708
2050;32900652;2149;1292;530;762
2051;32937552;2150;1098;473;625
2052;32891411;2151;1025;421;604
2053;32903025;2152;633;311;322
2054;46864661;2153;730;314;416
2055;32890752;2154;879;370;509
2056;42751604;2155;713;336;377
2057;45965974;2156;839;361;478
2058;43455685;2157;692;319;373
2059;3900928;2158;1403;632;771
2060;46323842;2159;558;235;323
2061;70004011;2160;1063;500;563
2062;32947234;2161;791;388;403
2063;46638331;2162;1316;553;763
2064;73005531;2163;1282;616;666
2065;32789358;2164;1472;663;809
2066;32875202;2165;1026;431;595
2067;32861114;2166;1491;627;864
2068;32969395;2167;1424;712;712
2069;32944381;2168;1356;678;678
2070;80338536;2169;1192;549;643
2071;41252560;2170;1305;588;717
2072;32805870;2171;930;428;502
2073;32821402;2172;1101;518;583
2074;32845630;2173;957;460;497
2075;18022043;2174;1247;624;623
2076;32855263;2175;964;415;549
2077;32795653;2176;656;328;328
2078;32863509;2177;672;303;369
2079;32766855;2178;881;379;502
2080;22067804;2179;1087;457;630
2081;80360379;2180;640;295;345
2082;32916606;2181;1047;482;565
2083;47607857;2182;1290;555;735
2084;31964242;2183;783;400;383
2085;32939362;2184;1185;581;604
2086;80331812;2185;1173;528;645
2087;32991343;2186;1458;569;889
2088;47886531;2187;608;286;322
2089;32818906;2188;1343;672;671
2090;43686661;2189;1037;519;518
2091;71470090;2190;701;281;420
2092;32960777;2191;956;459;497
2093;32786108;2192;1235;519;716
2094;41623719;2193;1266;507;759
2095;48490449;2194;1389;570;819
2096;76252709;2195;743;372;371
2097;72559155;2196;1165;548;617
2098;32942803;2197;645;271;374
2099;46378886;2198;676;311;365
2100;75098580;2199;1463;673;790
2101;75840363;2200;682;328;354
2102;75098579;2201;1394;711;683
2103;32791374;2202;814;342;472
2104;42055274;2203;963;405;558
2105;76812435;2204;897;458;439
2106;70331174;2205;531;234;297
2107;32760341;2206;1121;550;571
2108;32820801;2207;1489;641;848
2109;32832896;2208;1016;519;497
2110;32760342;2209;1229;603;626
2111;32829261;2210;523;220;303
2112;43170077;2211;848;391;457
2113;42398026;2212;519;260;259
2114;32110469;2213;1305;575;730
2115;32807991;2214;725;312;413
2116;80200859;2215;529;233;296
2117;32981783;2216;894;412;482
2118;32904612;2217;1399;602;797
2119;32960412;2218;1024;451;573
2120;32988426;2219;1420;625;795
2121;43990029;2220;933;402;531
2122;32918933;2221;633;285;348
2123;32964968;2222;963;386;577
2124;32944046;2223;1386;652;734
2125;42206526;2224;1311;564;747
2126;80620892;2225;552;249;303
2127;32861667;2226;1105;465;640
2128;44606846;2227;1441;577;864
2129;32965056;2228;1240;633;607
2130;10199140;2229;1348;634;714
2131;32790542;2230;1478;592;886
2132;43137161;2231;641;295;346
2133;43809167;2232;661;311;350
2134;17816239;2233;738;310;428
2135;45093235;2234;888;365;523
2136;32915056;2235;507;203;304
2137;29523281;2236;680;300;380
2138;32925536;2237;1367;698;669
2139;32789797;2238;664;293;371
2140;32970204;2239;519;208;311
2141;13274732;2240;1398;574;824
2142;32786156;2241;519;203;316
2143;23144070;2242;953;391;562
2144;81953767;2243;1223;539;684
2145;70248163;2244;1223;612;611
2146;88509991;2245;1291;581;710
2147;49067147;2246;1244;573;671
2148;18953424;2247;818;409;409
2149;92224902;2248;677;346;331
2150;91172264;2249;1377;634;743
2151;32795588;2250;1139;445;694
2152;42159500;2251;687;303;384
2153;42763438;2252;1402;547;855
2154;58909458;2253;777;389;388
2155;75155909;2254;730;314;416
2156;40675336;2255;977;469;508
2157;32887937;2256;852;375;477
2158;46495764;2257;1358;652;706
2159;42512586;2258;1419;682;737
2160;32858641;2259;871;392;479
2161;32930373;2260;623;268;355
2162;32763790;2261;2028;1014;1014
2163;32786832;2262;1692;728;964
2164;32833364;2263;2827;1386;1441
2165;32736786;2264;2029;832;1197
2166;32952442;2265;2585;1086;1499
2167;32917268;2266;2263;1041;1222
2168;32849788;2267;2116;1080;1036
2169;32966962;2268;2772;1414;1358
2170;32736699;2269;1570;613;957
2171;32848810;2270;1564;673;891
2172;27142984;2271;2961;1274;1687
2173;32959791;2272;2197;945;1252
2174;32982142;2273;2540;1093;1447
2175;32982351;2274;2227;1003;1224
2176;25489021;2275;1916;844;1072
2177;32130121;2276;1928;964;964
2178;32826393;2277;1994;838;1156
2179;7834224;2278;2251;946;1305
2180;7826400;2279;1925;905;1020
2181;32919399;2280;2718;1251;1467
2182;9658656;2281;2304;1037;1267
2183;6831148;2282;2116;889;1227
2184;65924429;2283;2493;1072;1421
2185;32852587;2284;2253;1059;1194
2186;48866622;2285;2347;1127;1220
2187;44867507;2286;1903;743;1160
2188;80252636;2287;1712;839;873
2189;32900041;2288;2870;1148;1722
2190;32826712;2289;1998;840;1158
2191;32851289;2290;2658;1117;1541
2192;32521793;2291;2203;948;1255
2193;32967308;2292;1777;782;995
2194;6830639;2293;1528;703;825
2195;19337167;2294;2408;1204;1204
2196;6800976;2295;2917;1401;1516
2197;32800635;2296;2569;1079;1490
2198;41910208;2297;2737;1287;1450
2199;44212728;2298;2920;1256;1664
2200;32974993;2299;2323;999;1324
2201;40059900;2300;1586;762;824
2202;32968024;2301;1961;903;1058
2203;27142700;2302;2927;1230;1697
2204;32865857;2303;2399;1056;1343
2205;10525603;2304;1909;840;1069
2206;32739158;2305;2011;845;1166
2207;16596958;2306;2100;903;1197
2208;32736535;2307;2629;1289;1340
2209;41618628;2308;1879;865;1014
2210;44896456;2309;2006;823;1183
2211;32958585;2310;2574;1287;1287
2212;32978936;2311;2861;1174;1687
2213;32787404;2312;1004;432;572
2214;32921614;2313;1008;394;614
2215;35578590;2314;816;327;489
2216;41478971;2315;1226;491;735
2217;17221365;2316;571;257;314
2218;65327164;2317;1264;607;657
2219;32943022;2318;1371;590;781
2220;32885732;2319;1094;449;645
2221;32863713;2320;547;252;295
2222;32778040;2321;1037;498;539
2223;71807833;2322;1030;526;504
2224;32867645;2323;1204;554;650
2225;32791992;2324;593;297;296
2226;32816740;2325;1177;471;706
2227;10723391;2326;1262;619;643
2228;32873017;2327;1176;553;623
2229;91331004;2328;902;424;478
2230;60058742;2329;630;259;371
2231;99271112;2330;780;312;468
2232;32827377;2331;1441;635;806
2233;32910047;2332;808;404;404
2234;32961323;2333;1215;584;631
2235;33264921;2334;712;364;348
2236;32979500;2335;575;253;322
2237;81973003;2336;1345;673;672
2238;41247286;2337;929;419;510
2239;25807111;2338;1202;601;601
2240;43469672;2339;741;304;437
2241;32808406;2340;549;237;312
2242;73300914;2341;719;338;381
2243;46772853;2342;764;314;450
2244;32953355;2343;1444;578;866
2245;45315311;2344;507;213;294
2246;32810428;2345;829;407;422
2247;32760212;2346;551;270;281
2248;32921258;2347;1400;588;812
2249;32913752;2348;595;298;297
2250;32735838;2349;718;367;351
2251;73630031;2350;974;439;535
2252;46929739;2351;1479;592;887
2253;32982989;2352;601;259;342
2254;32736310;2353;748;292;456
2255;25738806;2354;729;329;400
2256;32832035;2355;1009;404;605
2257;46597514;2356;822;411;411
2258;41117878;2357;1009;414;595
2259;6224689;2358;732;337;395
2260;32736977;2359;1007;514;493
2261;32841989;2360;1191;525;666
2262;32732564;2361;981;422;559
2263;32952471;2362;1472;633;839
2264;33263544;2363;556;240;316
2265;32949081;2364;841;379;462
2266;32951376;2365;950;475;475
2267;80620943;2366;685;343;342
2268;32849276;2367;891;419;472
2269;32827167;2368;872;375;497
2270;49149206;2369;646;272;374
2271;32541346;2370;1105;476;629
2272;32799016;2371;645;304;341
2273;32779306;2372;1144;470;674
2274;32849506;2373;679;340;339
2275;32739083;2374;830;332;498
2276;32815677;2375;533;267;266
2277;32832799;2376;1016;498;518
2278;32954747;2377;983;453;530
2279;32767530;2378;704;331;373
2280;42136158;2379;1278;550;728
2281;32736144;2380;1001;481;520
2282;84352475;2381;819;353;466
2283;32931775;2382;833;384;449
2284;80607484;2383;1337;616;721
2285;32620573;2384;1036;487;549
2286;33263021;2385;816;368;448
2287;3492215;2386;1055;486;569
2288;32905696;2387;899;360;539
2289;59352485;2388;1218;512;706
2290;32867710;2389;1297;545;752
2291;32914918;2390;861;345;516
2292;42112872;2391;1474;605;869
2293;32764184;2392;642;315;327
2294;43260741;2393;1269;584;685
2295;32961312;2394;645;284;361
2296;42395627;2395;560;269;291
2297;32974031;2396;1108;510;598
2298;32926039;2397;797;367;430
2299;44926221;2398;1205;555;650
2300;32798059;2399;871;436;435
2301;32793843;2400;680;279;401
2302;45696359;2401;605;291;314
2303;32919950;2402;773;379;394
2304;32861546;2403;970;379;591
2305;40631735;2404;1322;648;674
2306;48130171;2405;865;416;449
2307;32974876;2406;689;311;378
2308;41282002;2407;1205;567;638
2309;70525019;2408;1380;539;841
2310;46789763;2409;1467;661;806
2311;32932653;2410;852;358;494
2312;32922622;2411;818;360;458
2313;32777541;2412;783;400;383
2314;33263287;2413;767;330;437
2315;75438034;2414;983;443;540
2316;46660759;2415;529;265;264
2317;32823991;2416;795;311;484
2318;32834807;2417;878;448;430
2319;32931049;2418;1410;593;817
2320;32908009;2419;945;397;548
2321;42138107;2420;1052;432;620
2322;32973371;2421;654;269;385
2323;45692351;2422;1105;520;585
2324;43203535;2423;902;397;505
2325;90094712;2424;1418;568;850
2326;32916236;2425;1193;573;620
2327;32923109;2426;640;320;320
2328;40475864;2427;1414;623;791
2329;32860114;2428;926;399;527
2330;47124496;2429;1102;463;639
2331;32910204;2430;1452;610;842
2332;32986666;2431;1330;519;811
2333;42823349;2432;881;441;440
2334;32906028;2433;517;218;299
2335;17016458;2434;1249;500;749
2336;32986791;2435;1016;448;568
2337;67155296;2436;1485;743;742
2338;32909011;2437;1474;634;840
2339;41376457;2438;867;434;433
2340;32920529;2439;1278;563;715
2341;32920264;2440;1132;566;566
2342;32990216;2441;880;379;501
2343;32784711;2442;1421;597;824
2344;32933583;2443;761;328;433
2345;32967186;2444;592;237;355
2346;32822042;2445;760;304;456
2347;71047597;2446;951;419;532
2348;70565231;2447;1033;403;630
2349;32830286;2448;714;322;392
2350;70216552;2449;884;389;495
2351;32925964;2450;1102;518;584
2352;41286836;2451;1143;572;571
2353;32903995;2452;951;438;513
2354;70998649;2453;501;216;285
2355;32832965;2454;1060;446;614
2356;33242806;2455;548;242;306
2357;76844968;2456;776;342;434
2358;46265070;2457;619;248;371
2359;18078684;2458;868;348;520
2360;48726128;2459;1436;604;832
2361;70215480;2460;1119;571;548
2362;16634367;2461;773;364;409
2363;45936169;2462;1268;533;735
2364;70180879;2463;761;358;403
2365;8792571;2464;686;282;404
2366;52699237;2465;1207;592;615
2367;46561164;2466;1118;548;570
2368;46083358;2467;669;268;401
2369;32920069;2468;1014;416;598
2370;46223069;2469;572;258;314
2371;70164725;2470;567;261;306
2372;75143320;2471;986;493;493
2373;75007550;2472;1308;537;771
2374;42133026;2473;1495;598;897
2375;32990435;2474;1105;531;574
2376;75007549;2475;534;235;299
2377;45828116;2476;1093;547;546
2378;48799585;2477;1461;658;803
2379;32951480;2478;522;220;302
2380;32864463;2479;1380;677;703
2381;32957212;2480;1340;577;763
2382;32957371;2481;905;390;515
2383;32764674;2482;659;317;342
2384;32820311;2483;971;467;504
2385;32979591;2484;546;252;294
2386;9472077;2485;959;451;508
2387;32811799;2486;594;250;344
2388;32850192;2487;1303;522;781
2389;32979275;2488;1054;443;611
2390;32829510;2489;1420;611;809
2391;32979393;2490;1047;430;617
2392;80334952;2491;943;387;556
2393;32959840;2492;1094;449;645
2394;17599346;2493;883;363;520
2395;33337558;2494;1487;610;877
2396;32851735;2495;1020;459;561
2397;32921292;2496;1125;529;596
2398;32862792;2497;1474;649;825
2399;2821577;2498;697;349;348
2400;32962773;2499;1297;623;674
2401;19258394;2500;1458;613;845
2402;85234865;2501;995;408;587
2403;32821585;2502;1469;676;793
2404;18823539;2503;556;240;316
2405;32831409;2504;687;317;370
2406;32854653;2505;550;270;280
2407;32891420;2506;746;329;417
2408;32982847;2507;1403;562;841
2409;32966906;2508;1116;480;636
2410;32982700;2509;1462;658;804
2411;85649749;2510;870;409;461
2412;38254059;2511;1058;477;581
2413;32885720;2512;1475;635;840
2414;32904300;2513;714;357;357
2415;45162995;2514;585;234;351
2416;32933102;2515;884;363;521
2417;32920825;2516;1054;496;558
2418;18147382;2517;1424;613;811
2419;80253018;2518;1296;545;751
2420;32957548;2519;1438;633;805
2421;32807622;2520;1119;470;649
2422;17845189;2521;620;242;378
2423;32924892;2522;730;351;379
2424;32778042;2523;825;388;437
2425;33265394;2524;1341;644;697
2426;32940706;2525;1389;612;777
2427;32521156;2526;1497;704;793
2428;32864994;2527;594;262;332
2429;32763093;2528;732;323;409
2430;32763218;2529;897;458;439
2431;32823496;2530;1473;663;810
2432;32832054;2531;1407;676;731
2433;32772075;2532;636;312;324
2434;32977154;2533;1236;594;642
2435;32840847;2534;526;211;315
2436;32819924;2535;673;303;370
2437;32868154;2536;562;220;342
2438;17424657;2537;713;350;363
2439;32832387;2538;593;279;314
2440;44444158;2539;684;308;376
2441;32831897;2540;1296;597;699
2442;65772043;2541;1053;516;537
2443;32990342;2542;552;276;276
2444;32865963;2543;703;282;421
2445;32983468;2544;1021;419;602
2446;33262969;2545;1480;740;740
2447;39184524;2546;1372;618;754
2448;34312866;2547;1387;611;776
2449;32910353;2548;1079;443;636
2450;32983529;2549;1174;517;657
2451;32736964;2550;1144;515;629
2452;18213036;2551;1393;641;752
2453;32830951;2552;1387;625;762
2454;33714641;2553;671;289;382
2455;32971407;2554;572;275;297
2456;76965757;2555;1480;711;769
2457;42610978;2556;1475;605;870
2458;32841301;2557;1316;540;776
2459;32880377;2558;1463;747;716
2460;59850907;2559;740;363;377
2461;32732416;2560;889;392;497
2462;18885741;2561;1262;568;694
2463;32864439;2562;1288;554;734
2464;32791232;2563;555;228;327
2465;32949382;2564;1427;628;799
2466;43256893;2565;851;400;451
2467;47483636;2566;1296;623;673
2468;46063887;2567;1061;457;604
2469;44021472;2568;849;349;500
2470;43699172;2569;959;490;469
2471;80032098;2570;695;313;382
2472;32799464;2571;1017;448;569
2473;32861951;2572;1215;511;704
2474;32791891;2573;1487;610;877
2475;32834282;2574;604;266;338
2476;32928836;2575;1104;464;640
2477;32736160;2576;1169;538;631
2478;72666016;2577;907;391;516
2479;44508579;2578;821;337;484
2480;40301006;2579;825;413;412
2481;32733968;2580;1328;545;783
2482;72529050;2581;1322;595;727
2483;46875429;2582;1012;456;556
2484;32926510;2583;537;242;295
2485;32929427;2584;1353;542;811
2486;76952523;2585;700;322;378
2487;70926642;2586;1343;551;792
2488;71804841;2587;509;224;285
2489;8654745;2588;546;263;283
2490;76221354;2589;1243;523;720
2491;76136233;2590;686;330;356
2492;44256300;2591;994;418;576
2493;76842005;2592;1309;511;798
2494;40988978;2593;901;433;468
2495;43693149;2594;973;487;486
2496;32831925;2595;639;326;313
2497;32974817;2596;950;437;513
2498;32956476;2597;1145;584;561
2499;32975249;2598;863;415;448
2500;32916457;2599;884;345;539
2501;32790925;2600;1025;472;553
2502;32774577;2601;528;264;264
2503;32981570;2602;1169;480;689
2504;32942911;2603;551;265;286
2505;32805100;2604;847;339;508
2506;32944678;2605;592;231;361
2507;32828872;2606;1060;499;561
2508;32803184;2607;721;318;403
2509;32907675;2608;751;308;443
2510;40961492;2609;648;273;375
2511;10194147;2610;1444;578;866
2512;32783806;2611;733;345;388
2513;32916942;2612;1059;424;635
2514;32835143;2613;1140;559;581
2515;32782753;2614;1406;689;717
2516;10831497;2615;814;367;447
2517;32870078;2616;1471;618;853
2518;32774292;2617;919;469;450
2519;32871011;2618;1476;679;797
2520;32840508;2619;703;296;407
2521;32841331;2620;1372;645;727
2522;7970285;2621;1455;728;727
2523;10526722;2622;1393;697;696
2524;32983975;2623;701;295;406
2525;32870648;2624;1409;691;718
2526;32872470;2625;1286;605;681
2527;32735722;2626;1047;472;575
2528;32788660;2627;1246;536;710
2529;32944863;2628;959;490;469
2530;32970288;2629;1272;624;648
2531;32849301;2630;760;297;463
2532;95523440;2631;1343;565;778
2533;32784631;2632;680;334;346
2534;32968847;2633;1262;493;769
2535;40796024;2634;565;249;316
2536;32865673;2635;1484;713;771
2537;32949040;2636;776;357;419
2538;32917084;2637;1448;623;825
2539;32927870;2638;1273;548;725
2540;13274360;2639;953;420;533
2541;34641272;2640;659;323;336
2542;32809614;2641;1205;615;590
2543;32855714;2642;1261;618;643
2544;80500983;2643;1252;526;726
2545;43494501;2644;882;389;493
2546;32916351;2645;761;358;403
2547;46064357;2646;1324;583;741
2548;32842157;2647;789;363;426
2549;32791253;2648;648;318;330
2550;32939341;2649;581;256;325
2551;40197799;2650;889;356;533
2552;32812987;2651;1377;689;688
2553;71038982;2652;1188;476;712
2554;46724961;2653;1444;593;851
2555;42792265;2654;635;267;368
2556;80205070;2655;1149;586;563
2557;47474482;2656;507;208;299
2558;3357716;2657;676;291;385
2559;32735757;2658;1038;426;612
2560;47019626;2659;804;322;482
2561;32830227;2660;651;261;390
2562;45508818;2661;1203;590;613
2563;45627553;2662;917;386;531
2564;43679889;2663;796;319;477
2565;43723661;2664;851;341;510
2566;32783422;2665;824;404;420
2567;32960138;2666;1428;572;856
2568;46895877;2667;1448;724;724
2569;32732241;2668;1068;492;576
2570;40584958;2669;814;407;407
2571;47000503;2670;591;272;319
2572;32875426;2671;1254;502;752
2573;80279622;2672;670;335;335
2574;32853461;2673;1339;603;736
2575;43240789;2674;946;388;558
2576;32855586;2675;891;384;507
2577;42478972;2676;1374;687;687
2578;41422690;2677;1091;470;621
2579;32795626;2678;1481;741;740
2580;46353806;2679;866;416;450
2581;74213356;2680;764;375;389
2582;72397209;2681;957;422;535
2583;86544978;2682;977;460;517
2584;33265982;2683;1061;436;625
2585;32858258;2684;661;291;370
2586;44620896;2685;728;314;414
2587;32842107;2686;1405;562;843
2588;32935596;2687;963;443;520
2589;32937591;2688;995;478;517
2590;32543128;2689;744;350;394
2591;32936225;2690;573;230;343
2592;32848749;2691;1267;495;772
2593;32935968;2692;782;368;414
2594;32936462;2693;1134;488;646
2595;32948544;2694;718;288;430
2596;43239914;2695;600;288;312
2597;32937968;2696;515;263;252
2598;41722332;2697;972;448;524
2599;32543134;2698;916;449;467
2600;32917712;2699;685;329;356
2601;32934420;2700;899;450;449
2602;19226297;2701;719;295;424
2603;32543106;2702;704;282;422
2604;32901287;2703;656;276;380
2605;32935084;2704;756;303;453
2606;32938450;2705;1463;586;877
2607;32785993;2706;1373;618;755
2608;32896856;2707;730;307;423
2609;41558027;2708;813;415;398
2610;32780132;2709;952;448;504
2611;32899529;2710;1411;579;832
2612;32937487;2711;566;221;345
2613;19701175;2712;1172;528;644
2614;32937015;2713;1447;652;795
2615;32768281;2714;695;285;410
2616;35125785;2715;1424;627;797
2617;32828769;2716;1019;469;550
2618;42234108;2717;1175;470;705
2619;32980130;2718;947;474;473
2620;32541355;2719;1423;712;711
2621;32925961;2720;1258;617;641
2622;32951039;2721;502;216;286
2623;66939901;2722;1192;501;691
2624;32865189;2723;1335;548;787
2625;32958168;2724;537;210;327
2626;32933149;2725;829;324;505
2627;32922813;2726;676;338;338
2628;32965039;2727;927;408;519
2629;32859201;2728;621;292;329
2630;32923027;2729;803;402;401
2631;32989794;2730;846;356;490
2632;32922720;2731;1092;536;556
2633;32869954;2732;1309;616;693
2634;32913761;2733;1437;662;775
2635;32943956;2734;1117;458;659
2636;32981762;2735;665;333;332
2637;94352484;2736;1120;448;672
2638;32813647;2737;1235;618;617
2639;40698313;2738;1076;474;602
2640;32809982;2739;1430;687;743
2641;17409805;2740;655;302;353
2642;32854723;2741;1552;637;915
2643;32913026;2742;2044;982;1062
2644;32128359;2743;2487;1045;1442
2645;4634685;2744;1684;758;926
2646;40015461;2745;1529;658;871
2647;32982119;2746;1543;679;864
2648;32885898;2747;1711;839;872
2649;43136135;2748;1872;862;1010
2650;32848433;2749;2143;943;1200
2651;32956390;2750;2748;1292;1456
2652;32885662;2751;2712;1167;1545
2653;44126623;2752;2296;1126;1170
2654;42958420;2753;2217;976;1241
2655;32979552;2754;2099;840;1259
2656;32971228;2755;2420;1235;1185
2657;32809532;2756;2132;853;1279
2658;43839683;2757;1570;754;816
2659;40054169;2758;2744;1180;1564
2660;32940302;2759;2014;967;1047
2661;32913639;2760;1813;889;924
2662;18905555;2761;1884;961;923
2663;42455750;2762;2236;940;1296
2664;32973455;2763;2165;888;1277
2665;32949029;2764;1654;827;827
2666;32942649;2765;2068;910;1158
2667;32887142;2766;2894;1158;1736
2668;32772449;2767;960;384;576
2669;16717777;2768;1488;611;877
2670;18901277;2769;1006;493;513
2671;43005413;2770;1194;490;704
2672;32809267;2771;886;435;451
2673;70015992;2772;1423;698;725
2674;72533554;2773;543;272;271
2675;32975424;2774;570;280;290
2676;46487686;2775;533;246;287
2677;47562242;2776;648;299;349
2678;64453172;2777;1224;564;660
2679;32985876;2778;1476;606;870
2680;42136167;2779;510;250;260
2681;25004994;2780;541;276;265
2682;70015351;2781;814;399;415
2683;32906576;2782;974;468;506
2684;43248622;2783;1215;474;741
2685;46617087;2784;563;259;304
2686;75107823;2785;1389;681;708
2687;75155943;2786;1195;550;645
2688;74222574;2787;1483;683;800
2689;46903922;2788;1329;532;797
2690;47714031;2789;1233;518;715
2691;72695968;2790;1320;621;699
2692;32984842;2791;903;416;487
2693;32854053;2792;502;246;256
2694;42830930;2793;506;243;263
2695;73479991;2794;1298;624;674
2696;72642796;2795;690;283;407
2697;45610729;2796;1036;467;569
2698;32837546;2797;1166;537;629
2699;44274866;2798;1128;553;575
2700;32818294;2799;1476;738;738
2701;25488176;2800;700;280;420
2702;76155701;2801;539;270;269
2703;42764780;2802;507;213;294
2704;45095886;2803;606;261;345
2705;43105437;2804;1192;561;631
2706;45959586;2805;1418;610;808
2707;32932762;2806;1483;742;741
2708;32847911;2807;839;344;495
2709;32904342;2808;562;225;337
2710;32932253;2809;811;357;454
2711;32841816;2810;1110;456;654
2712;32939307;2811;958;384;574
2713;32836647;2812;680;266;414
2714;32838063;2813;845;389;456
2715;32829528;2814;1039;468;571
2716;32931965;2815;807;364;443
2717;32865326;2816;1438;590;848
2718;32926283;2817;986;415;571
2719;3499352;2818;599;276;323
2720;95137091;2819;1148;460;688
2721;32945596;2820;1112;545;567
2722;32991203;2821;1370;590;780
2723;32837200;2822;711;335;376
2724;32811962;2823;1195;478;717
2725;43594171;2824;743;305;438
2726;32911600;2825;509;255;254
2727;32939696;2826;1254;590;664
2728;32907233;2827;662;259;403
2729;40687365;2828;1356;597;759
2730;18091648;2829;1393;613;780
2731;43693158;2830;1197;599;598
2732;32773064;2831;1112;556;556
2733;43760250;2832;1158;498;660
2734;40885586;2833;600;270;330
2735;32542980;2834;1364;560;804
2736;32843503;2835;1500;765;735
2737;44033506;2836;682;335;347
2738;32963591;2837;1441;620;821
2739;32945654;2838;620;273;347
2740;45010064;2839;519;260;259
2741;32841342;2840;1182;509;673
2742;17915959;2841;1455;568;887
2743;42106427;2842;1246;536;710
2744;80200136;2843;1004;452;552
2745;32843962;2844;1099;473;626
2746;32864074;2845;687;289;398
2747;42116481;2846;729;299;430
2748;40950193;2847;1357;652;705
2749;32990218;2848;701;302;399
2750;44955399;2849;1254;540;714
2751;72103406;2850;1454;713;741
2752;32927243;2851;954;487;467
2753;32918866;2852;908;418;490
2754;32542014;2853;1315;605;710
2755;32932254;2854;882;371;511
2756;32802191;2855;595;304;291
2757;32869935;2856;1066;491;575
2758;32811883;2857;1086;457;629
2759;45630480;2858;901;361;540
2760;32843718;2859;933;458;475
2761;30241926;2860;528;212;316
2762;70686318;2861;1225;576;649
2763;32974659;2862;1021;450;571
2764;32942302;2863;1491;657;834
2765;32812636;2864;951;438;513
2766;32852308;2865;907;372;535
2767;32832344;2866;1493;642;851
2768;33342800;2867;895;358;537
2769;44623321;2868;792;333;459
2770;32856851;2869;963;424;539
2771;43375527;2870;1386;596;790
2772;47294732;2871;1138;524;614
2773;41592310;2872;879;352;527
2774;32969535;2873;962;481;481
2775;44268745;2874;734;331;403
2776;32924204;2875;915;431;484
2777;46706759;2876;648;324;324
2778;70015145;2877;644;297;347
2779;32794081;2878;541;271;270
2780;41539889;2879;578;289;289
2781;71038960;2880;645;310;335
2782;32807724;2881;1277;499;778
2783;32942776;2882;1354;677;677
2784;80688851;2883;1450;667;783
2785;45724933;2884;578;295;283
2786;9333718;2885;552;271;281
2787;32814803;2886;1141;525;616
2788;61363423;2887;611;251;360
2789;73144940;2888;796;383;413
2790;14124609;2889;533;208;325
2791;45024881;2890;948;380;568
2792;73386158;2891;1008;414;594
2793;43469937;2892;550;259;291
2794;75510031;2893;593;297;296
2795;44222252;2894;774;318;456
2796;32481308;2895;1054;485;569
2797;32986449;2896;1222;575;647
2798;76981170;2897;1282;654;628
2799;32931158;2898;704;310;394
2800;32798876;2899;1153;519;634
2801;32737173;2900;799;400;399
2802;32805117;2901;618;303;315
2803;32967863;2902;806;403;403
2804;32986260;2903;1373;577;796
2805;32542708;2904;1140;513;627
2806;32795742;2905;602;241;361
2807;3888561;2906;571;257;314
2808;32855855;2907;552;232;320
2809;16704653;2908;1258;604;654
2810;32808733;2909;676;298;378
2811;32919043;2910;1380;580;800
2812;32932880;2911;715;344;371
2813;32814744;2912;780;383;397
2814;32740953;2913;636;299;337
2815;43871495;2914;1248;562;686
2816;80606994;2915;1491;671;820
2817;43136241;2916;987;455;532
2818;32962178;2917;1169;515;654
2819;32961572;2918;1035;456;579
2820;32888728;2919;1500;600;900
2821;32802529;2920;1271;509;762
2822;17622528;2921;795;390;405
2823;40503369;2922;1096;494;602
2824;32922660;2923;793;373;420
2825;32905149;2924;580;261;319
2826;32774215;2925;941;471;470
2827;32778376;2926;1345;538;807
2828;80251499;2927;1014;487;527
2829;32781365;2928;795;398;397
2830;32855948;2929;973;487;486
2831;80251449;2930;531;218;313
2832;42985976;2931;1449;696;753
2833;32830575;2932;586;252;334
2834;32860107;2933;964;415;549
2835;80436665;2934;740;341;399
2836;32854791;2935;1064;479;585
2837;42110376;2936;929;400;529
2838;32845286;2937;1321;621;700
2839;32810875;2938;904;462;442
2840;43206643;2939;817;409;408
2841;80192737;2940;1279;525;754
2842;32988514;2941;839;344;495
2843;43621575;2942;534;219;315
2844;32807308;2943;1159;487;672
2845;32941732;2944;517;238;279
2846;83423611;2945;886;408;478
2847;80194555;2946;674;337;337
2848;32765810;2947;668;288;380
2849;32981964;2948;1100;528;572
2850;80194990;2949;996;419;577
2851;41732088;2950;609;268;341
2852;32761926;2951;1445;564;881
2853;24275018;2952;653;281;372
2854;32824529;2953;923;444;479
2855;43287030;2954;708;319;389
2856;32796050;2955;1119;448;671
2857;40511572;2956;811;382;429
2858;32542244;2957;712;292;420
2859;32763279;2958;1162;454;708
2860;32821780;2959;1076;442;634
2861;32820461;2960;1421;597;824
2862;40036834;2961;1399;672;727
2863;40326512;2962;785;354;431
2864;32812074;2963;615;290;325
2865;32941406;2964;1308;550;758
2866;32960025;2965;1459;628;831
2867;32843251;2966;740;333;407
2868;32764276;2967;664;286;378
2869;32826591;2968;1036;498;538
2870;32973796;2969;1017;468;549
2871;32989612;2970;651;280;371
2872;33261797;2971;860;370;490
2873;32829704;2972;898;405;493
2874;40435542;2973;779;328;451
2875;32968710;2974;1232;518;714
2876;32967874;2975;1449;711;738
2877;41631894;2976;530;228;302
2878;32924490;2977;1173;564;609
2879;43728561;2978;1477;665;812
2880;32854242;2979;963;405;558
2881;32966540;2980;787;307;480
2882;32898334;2981;1424;584;840
2883;32976874;2982;1310;577;733
2884;45270172;2983;1156;451;705
2885;32785332;2984;1257;642;615
2886;32777995;2985;879;343;536
2887;32938963;2986;1344;605;739
2888;17857711;2987;1300;533;767
2889;42651931;2988;706;339;367
2890;32904555;2989;1290;620;670
2891;45114975;2990;561;275;286
2892;43681162;2991;771;355;416
2893;32839303;2992;1293;556;737
2894;32797162;2993;943;463;480
2895;32863585;2994;1361;640;721
2896;42999482;2995;822;370;452
2897;32845478;2996;1123;472;651
2898;80561560;2997;954;430;524
2899;43499858;2998;593;285;308
2900;32827649;2999;1495;733;762
2901;18083446;3000;937;394;543
2902;32812263;3001;1042;469;573
2903;84922750;3002;975;410;565
2904;32867314;3003;1445;578;867
2905;90920268;3004;1193;573;620
2906;80574480;3005;629;290;339
2907;43044199;3006;1316;632;684
2908;52073984;3007;1465;660;805
2909;32932966;3008;1480;592;888
2910;31749809;3009;1436;604;832
2911;32967420;3010;1491;716;775
2912;6706311;3011;1295;596;699
2913;32861038;3012;512;210;302
2914;32860141;3013;764;352;412
2915;93281177;3014;1452;654;798
2916;32869506;3015;600;258;342
2917;32860868;3016;596;239;357
2918;32906450;3017;663;312;351
2919;62192248;3018;798;376;422
2920;32855227;3019;551;226;325
2921;32771350;3020;1228;492;736
2922;32920227;3021;914;430;484
2923;32916859;3022;1422;598;824
2924;32892859;3023;1309;603;706
2925;18220060;3024;871;419;452
2926;32905308;3025;1044;522;522
2927;32812346;3026;845;389;456
2928;32789790;3027;537;264;273
2929;32839454;3028;897;368;529
2930;42632033;3029;768;384;384
2931;32915620;3030;1188;583;605
2932;32922453;3031;1094;537;557
2933;32839921;3032;951;381;570
2934;65123388;3033;1378;689;689
2935;32784125;3034;631;310;321
2936;97179638;3035;902;433;469
2937;42751669;3036;1124;484;640
2938;32777652;3037;616;278;338
2939;42084658;3038;1060;467;593
2940;60204770;3039;1073;494;579
2941;32908945;3040;1214;559;655
2942;32323333;3041;705;339;366
2943;81487915;3042;623;287;336
2944;37377129;3043;1395;600;795
2945;70241983;3044;885;434;451
2946;43081820;3045;1284;578;706
2947;32825637;3046;673;303;370
2948;32854376;3047;672;343;329
2949;39634932;3048;1210;521;689
2950;42393470;3049;1397;699;698
2951;32797662;3050;1435;618;817
2952;32780223;3051;516;222;294
2953;20518145;3052;643;290;353
2954;32762853;3053;1233;629;604
2955;33261243;3054;589;295;294
2956;40554148;3055;1329;665;664
2957;42569030;3056;1226;491;735
2958;32783295;3057;1397;671;726
2959;43005119;3058;1284;553;731
2960;43504411;3059;789;363;426
2961;32964168;3060;534;214;320
2962;59309273;3061;1266;608;658
2963;91227372;3062;1040;520;520
2964;43097491;3063;986;464;522
2965;409115;3064;1472;663;809
2966;32840553;3065;570;263;307
2967;47311657;3066;1257;516;741
2968;32932935;3067;1489;656;833
2969;40364780;3068;973;419;554
2970;46532711;3069;1399;630;769
2971;32732927;3070;638;294;344
2972;7489284;3071;831;391;440
2973;74608959;3072;509;245;264
2974;47964820;3073;1418;639;779
2975;32790158;3074;1336;615;721
2976;32974818;3075;1062;531;531
2977;32805223;3076;574;282;292
2978;32857330;3077;831;350;481
2979;32887957;3078;1479;696;783
2980;40553213;3079;694;320;374
2981;33675415;3080;1176;577;599
2982;8992602;3081;1164;536;628
2983;43454643;3082;807;364;443
2984;43633946;3083;1344;659;685
2985;32940648;3084;1106;443;663
2986;32760136;3085;844;347;497
2987;32841681;3086;1084;456;628
2988;33674490;3087;1284;642;642
2989;80575518;3088;1093;481;612
2990;32956561;3089;725;334;391
2991;32826797;3090;859;396;463
2992;32888048;3091;1091;535;556
2993;32386603;3092;841;404;437
2994;32933287;3093;522;225;297
2995;19676889;3094;1237;532;705
2996;42003809;3095;1130;464;666
2997;67052025;3096;1373;618;755
2998;32829162;3097;842;421;421
2999;44421528;3098;1215;523;692
3000;8359709;3099;880;405;475
3001;32797277;3100;689;345;344
3002;41272520;3101;1119;482;637
3003;32863375;3102;827;414;413
3004;80180718;3103;528;206;322
3005;18145192;3104;681;280;401
3006;32854904;3105;1292;608;684
3007;32878826;3106;959;432;527
3008;32963253;3107;677;346;331
3009;40825169;3108;918;450;468
3010;32771767;3109;1425;627;798
3011;32788067;3110;879;449;430
3012;32929728;3111;1325;597;728
3013;32783487;3112;1142;583;559
3014;30834207;3113;1388;625;763
3015;32859581;3114;525;268;257
3016;32783223;3115;1074;430;644
3017;33265793;3116;595;238;357
3018;32775268;3117;672;310;362
3019;32782782;3118;1133;544;589
3020;32939107;3119;1358;571;787
3021;42846803;3120;1112;434;678
3022;32784672;3121;1162;558;604
3023;32782700;3122;897;440;457
3024;32915781;3123;1134;499;635
3025;80346032;3124;564;232;332
3026;41590293;3125;1206;495;711
3027;32774306;3126;589;271;318
3028;32851036;3127;711;299;412
3029;32789441;3128;553;227;326
3030;32928747;3129;845;389;456
3031;44865783;3130;1406;577;829
3032;44555912;3131;742;290;452
3033;32866634;3132;1027;442;585
3034;32838339;3133;1137;558;579
3035;32809551;3134;1358;652;706
3036;32912955;3135;1360;680;680
3037;32843376;3136;939;376;563
3038;32829409;3137;570;234;336
3039;32945556;3138;1423;712;711
3040;32824166;3139;1109;466;643
3041;33261112;3140;782;321;461
3042;32854793;3141;1426;713;713
3043;9868583;3142;1427;700;727
3044;32860203;3143;1083;531;552
3045;32847840;3144;779;343;436
3046;32796353;3145;625;244;381
3047;44118901;3146;703;289;414
3048;68561830;3147;660;330;330
3049;80180844;3148;1136;534;602
3050;32909135;3149;714;357;357
3051;32960011;3150;661;278;383
3052;32838898;3151;925;435;490
3053;32860000;3152;814;383;431
3054;32824257;3153;1325;610;715
3055;32836394;3154;1447;738;709
3056;40345839;3155;843;371;472
3057;30801357;3156;913;439;474
3058;32969431;3157;604;254;350
3059;32823171;3158;1247;512;735
3060;32850627;3159;1085;445;640
3061;32777724;3160;1240;534;706
3062;32804409;3161;1388;694;694
3063;32857175;3162;807;364;443
3064;40768816;3163;1466;690;776
3065;41665566;3164;522;261;261
3066;41507478;3165;1343;591;752
3067;32940462;3166;1162;570;592
3068;32138863;3167;524;247;277
3069;41399543;3168;767;307;460
3070;32817749;3169;1297;623;674
3071;62138604;3170;830;391;439
3072;32861044;3171;1413;693;720
3073;32981203;3172;899;378;521
3074;17899342;3173;1173;528;645
3075;33264384;3174;560;280;280
3076;32980802;3175;1149;552;597
3077;40224016;3176;990;426;564
3078;32820611;3177;1271;572;699
3079;32967822;3178;513;216;297
3080;32982886;3179;1463;615;848
3081;6408433;3180;1386;624;762
3082;32736167;3181;835;401;434
3083;32938979;3182;1347;634;713
3084;32983323;3183;1113;512;601
3085;32832098;3184;933;383;550
3086;32972745;3185;1278;601;677
3087;17967902;3186;941;443;498
3088;32774252;3187;539;232;307
3089;32839992;3188;582;257;325
3090;43152645;3189;1195;478;717
3091;41198826;3190;1201;601;600
3092;32941623;3191;570;263;307
3093;32834522;3192;892;375;517
3094;32976135;3193;2696;1052;1644
3095;41383294;3194;2501;1276;1225
3096;32926712;3195;1904;857;1047
3097;8672249;3196;2552;1072;1480
3098;32764587;3197;2659;1064;1595
3099;33260489;3198;2486;1119;1367
3100;32811874;3199;1991;996;995
3101;32891235;3200;1716;773;943
3102;32931959;3201;1460;599;861
3103;32982465;3202;861;422;439
3104;6804489;3203;1382;678;704
3105;45243332;3204;1139;502;637
3106;32979995;3205;1009;515;494
3107;9243502;3206;556;245;311
3108;32921788;3207;594;250;344
3109;32769605;3208;941;443;498
3110;32862726;3209;1464;601;863
3111;18055570;3210;1046;419;627
3112;32740559;3211;1165;583;582
3113;32990110;3212;549;270;279
3114;32932809;3213;1335;588;747
3115;19329219;3214;675;324;351
3116;6874171;3215;1176;600;576
3117;32976345;3216;834;367;467
3118;32956096;3217;596;239;357
3119;32970824;3218;942;415;527
3120;40762733;3219;575;259;316
3121;9381291;3220;980;412;568
3122;18190992;3221;777;350;427
3123;32940165;3222;1049;431;618
3124;32963646;3223;671;289;382
3125;33261033;3224;1014;477;537
3126;18858633;3225;938;376;562
3127;41846984;3226;1303;626;677
3128;32780258;3227;886;435;451
3129;32736247;3228;1492;612;880
3130;33263723;3229;1356;543;813
3131;80338447;3230;788;339;449
3132;43308632;3231;1384;692;692
3133;4641737;3232;1196;467;729
3134;41748606;3233;1139;456;683
3135;32875256;3234;808;332;476
3136;32973368;3235;938;460;478
3137;32916393;3236;1315;632;683
3138;32976399;3237;627;301;326
3139;43590990;3238;724;348;376
3140;42881439;3239;1274;650;624
3141;32949637;3240;981;471;510
3142;40318567;3241;895;358;537
3143;31607029;3242;762;313;449
3144;32931709;3243;1131;453;678
3145;32865341;3244;1227;479;748
3146;43600777;3245;884;354;530
3147;32919378;3246;592;302;290
3148;32868286;3247;745;373;372
3149;32736703;3248;1057;423;634
3150;80205079;3249;944;472;472
3151;32951229;3250;1370;603;767
3152;32542921;3251;884;407;477
3153;32929815;3252;860;413;447
3154;32905861;3253;1220;549;671
3155;41917969;3254;1435;603;832
3156;43484212;3255;1476;694;782
3157;43086478;3256;1024;431;593
3158;31614405;3257;922;388;534
3159;32960153;3258;773;341;432
3160;32958678;3259;1174;482;692
3161;32790319;3260;997;449;548
3162;32736227;3261;697;300;397
3163;42679505;3262;510;204;306
3164;33348079;3263;953;477;476
3165;32966464;3264;505;243;262
3166;32918225;3265;766;315;451
3167;32910189;3266;685;274;411
3168;32773964;3267;733;286;447
3169;32979186;3268;781;344;437
3170;19427827;3269;1407;563;844
3171;32832215;3270;1202;541;661
3172;32861148;3271;574;276;298
3173;32905082;3272;1179;602;577
3174;44979486;3273;1292;556;736
3175;32868157;3274;548;269;279
3176;44383789;3275;681;314;367
3177;41665973;3276;1238;619;619
3178;45207709;3277;1362;613;749
3179;32979385;3278;1068;534;534
3180;80620871;3279;1350;608;742
3181;40290246;3280;1277;537;740
3182;80195179;3281;1395;656;739
3183;10261943;3282;1341;550;791
3184;20053564;3283;1019;439;580
3185;32860481;3284;882;415;467
3186;41732066;3285;1119;560;559
3187;19861837;3286;1395;586;809
3188;45584689;3287;746;359;387
3189;32837558;3288;1087;457;630
3190;43931705;3289;597;293;304
3191;32106143;3290;815;367;448
3192;32952821;3291;1383;651;732
3193;45673242;3292;524;247;277
3194;32931115;3293;511;241;270
3195;41652641;3294;995;398;597
3196;40458880;3295;1240;521;719
3197;19431242;3296;834;359;475
3198;32979884;3297;1255;615;640
3199;32790991;3298;1317;514;803
3200;41401718;3299;568;239;329
3201;40030363;3300;537;258;279
3202;19090211;3301;928;372;556
3203;45805411;3302;1137;455;682
3204;47157811;3303;1463;732;731
3205;32950107;3304;1123;461;662
3206;32987519;3305;666;320;346
3207;44139615;3306;582;286;296
3208;46173807;3307;1139;559;580
3209;32938340;3308;507;213;294
3210;48126361;3309;979;441;538
3211;48630803;3310;1422;626;796
3212;40595679;3311;1337;656;681
3213;32987422;3312;1135;511;624
3214;19330763;3313;992;397;595
3215;32849119;3314;730;336;394
3216;33264836;3315;1002;431;571
3217;43339510;3316;586;258;328
3218;32839707;3317;681;341;340
3219;32844273;3318;1347;553;794
3220;73447913;3319;746;306;440
3221;32961304;3320;1028;443;585
3222;46121912;3321;961;414;547
3223;43595697;3322;729;358;371
3224;32951089;3323;693;319;374
3225;32845930;3324;1012;456;556
3226;32952896;3325;1471;648;823
3227;32823500;3326;1271;496;775
3228;76302100;3327;1131;498;633
3229;46467299;3328;756;356;400
3230;48597455;3329;1436;733;703
3231;8440626;3330;687;275;412
3232;46457552;3331;1204;482;722
3233;13005477;3332;638;307;331
3234;44887986;3333;1109;488;621
3235;43377737;3334;916;440;476
3236;44236685;3335;1404;604;800
3237;48725096;3336;936;422;514
3238;76389155;3337;511;241;270
3239;46285027;3338;605;309;296
3240;32129598;3339;695;313;382
3241;18861069;3340;1099;550;549
3242;32976240;3341;1084;467;617
3243;32798495;3342;1273;637;636
3244;41581351;3343;1177;542;635
3245;32867640;3344;1042;428;614
3246;32808046;3345;865;424;441
3247;32911092;3346;577;277;300
3248;32907054;3347;601;295;306
3249;32964782;3348;1395;684;711
3250;32948818;3349;529;239;290
3251;4919102;3350;959;394;565
3252;32854553;3351;961;404;557
3253;47580254;3352;1249;600;649
3254;46185321;3353;1245;598;647
3255;32980051;3354;1018;438;580
3256;8258404;3355;501;231;270
3257;33260281;3356;646;259;387
3258;32961348;3357;518;254;264
3259;38937971;3358;630;303;327
3260;32918706;3359;1134;556;578
3261;41570134;3360;1141;445;696
3262;41921802;3361;641;263;378
3263;32857418;3362;1390;695;695
3264;32904517;3363;913;375;538
3265;32843410;3364;1095;493;602
3266;42158798;3365;844;372;472
3267;32840763;3366;730;314;416
3268;19181884;3367;852;358;494
3269;91040471;3368;1479;622;857
3270;32918677;3369;708;319;389
3271;32813140;3370;536;263;273
3272;32816673;3371;1092;459;633
3273;32850034;3372;966;493;473
3274;32816523;3373;1209;496;713
3275;41982393;3374;505;253;252
3276;32981932;3375;997;459;538
3277;32918942;3376;1412;706;706
3278;32836692;3377;1132;510;622
3279;32792155;3378;626;288;338
3280;42475014;3379;955;373;582
3281;32919965;3380;659;310;349
3282;32983485;3381;1233;605;628
3283;42772008;3382;1287;657;630
3284;32783674;3383;1109;488;621
3285;32868971;3384;1071;482;589
3286;41049686;3385;1173;470;703
3287;32836742;3386;533;219;314
3288;63311138;3387;1315;513;802
3289;32873168;3388;506;233;273
3290;32798045;3389;1186;593;593
3291;32961016;3390;897;449;448
3292;26935191;3391;1404;562;842
3293;32973323;3392;698;287;411
3294;29728281;3393;609;256;353
3295;32788589;3394;1211;497;714
3296;10424243;3395;1267;545;722
3297;32834274;3396;1316;527;789
3298;32888366;3397;1466;646;820
3299;32926069;3398;600;258;342
3300;32962432;3399;517;207;310
3301;9850194;3400;1163;501;662
3302;32941306;3401;607;243;364
3303;15593260;3402;1184;498;686
3304;41699870;3403;500;200;300
3305;40901827;3404;580;256;324
3306;32967410;3405;1088;534;554
3307;24543489;3406;1305;601;704
3308;32921014;3407;1043;449;594
3309;32829154;3408;989;475;514
3310;32868930;3409;664;299;365
3311;32771106;3410;1006;443;563
3312;32763224;3411;685;322;363
3313;72711178;3412;1213;595;618
3314;32865919;3413;509;214;295
3315;32901212;3414;549;264;285
3316;32823556;3415;692;305;387
3317;16644952;3416;705;318;387
3318;32920511;3417;1043;532;511
3319;32841473;3418;1136;557;579
3320;32966379;3419;541;222;319
3321;40279450;3420;900;450;450
3322;32784688;3421;773;387;386
3323;41207136;3422;1273;561;712
3324;32865076;3423;815;326;489
3325;43359572;3424;1424;698;726
3326;5323638;3425;953;401;552
3327;32830204;3426;946;426;520
3328;32829344;3427;536;226;310
3329;32763855;3428;821;337;484
3330;70179525;3429;848;357;491
3331;32912952;3430;957;460;497
3332;46149427;3431;725;356;369
3333;32813210;3432;1270;610;660
3334;45354324;3433;837;386;451
3335;32738025;3434;500;230;270
3336;32735298;3435;660;317;343
3337;11648607;3436;1321;648;673
3338;92167991;3437;908;427;481
3339;32784418;3438;1153;589;564
3340;70176065;3439;1493;687;806
3341;42620155;3440;608;250;358
3342;70208993;3441;1149;495;654
3343;32972435;3442;1468;588;880
3344;18188719;3443;1241;596;645
3345;42066359;3444;1055;422;633
3346;40754030;3445;828;332;496
3347;32791475;3446;1200;600;600
3348;45794350;3447;955;392;563
3349;32822132;3448;661;272;389
3350;32930982;3449;945;435;510
3351;32866392;3450;680;266;414
3352;7602734;3451;1273;612;661
3353;87171369;3452;987;445;542
3354;80249800;3453;510;261;249
3355;32839219;3454;1437;575;862
3356;63279960;3455;1248;487;761
3357;32910441;3456;1096;527;569
3358;25560840;3457;1480;592;888
3359;32945739;3458;1351;581;770
3360;19234956;3459;884;354;530
3361;6437851;3460;1172;586;586
3362;32798234;3461;1206;603;603
3363;32859740;3462;1345;565;780
3364;6800092;3463;822;321;501
3365;32925982;3464;548;269;279
3366;32740664;3465;1212;497;715
3367;44154834;3466;1134;533;601
3368;32861282;3467;1314;644;670
3369;32974667;3468;1247;549;698
3370;9511283;3469;1232;604;628
3371;40508163;3470;1156;509;647
3372;32784830;3471;1218;512;706
3373;42230743;3472;755;333;422
3374;43625207;3473;912;365;547
3375;41585576;3474;804;394;410
3376;32840812;3475;1223;612;611
3377;32804028;3476;1173;540;633
3378;32966740;3477;545;213;332
3379;32948982;3478;806;412;394
3380;32842927;3479;704;310;394
3381;66257550;3480;502;216;286
3382;32769740;3481;1406;563;843
3383;40256415;3482;594;262;332
3384;32926944;3483;1078;453;625
3385;32948418;3484;1456;612;844
3386;32543123;3485;1234;617;617
3387;32936883;3486;1266;608;658
3388;43036273;3487;1381;594;787
3389;32865726;3488;646;298;348
3390;32841428;3489;842;363;479
3391;41153782;3490;1047;503;544
3392;32936146;3491;1392;641;751
3393;32948406;3492;1129;463;666
3394;19227128;3493;718;316;402
3395;41512331;3494;560;275;285
3396;80622539;3495;1171;492;679
3397;32891897;3496;1283;539;744
3398;32936205;3497;717;316;401
3399;40628881;3498;712;314;398
3400;32965414;3499;757;387;370
3401;32925057;3500;954;477;477
3402;32937925;3501;1330;532;798
3403;32948501;3502;1238;570;668
3404;32935165;3503;1464;645;819
3405;32935408;3504;1418;681;737
3406;32935804;3505;852;392;460
3407;42170189;3506;965;473;492
3408;75971200;3507;1025;441;584
3409;32911724;3508;1041;511;530
3410;32956414;3509;1375;660;715
3411;32815089;3510;1353;542;811
3412;32943950;3511;659;284;375
3413;16607776;3512;1406;661;745
3414;32763603;3513;628;264;364
3415;43613009;3514;1387;555;832
3416;32938843;3515;633;304;329
3417;32914342;3516;800;368;432
3418;32930075;3517;1102;441;661
3419;32976730;3518;1499;720;779
3420;32774499;3519;761;320;441
3421;32827899;3520;901;352;549
3422;32940901;3521;1006;443;563
3423;32826542;3522;919;359;560
3424;32932447;3523;1392;683;709
3425;43556208;3524;979;412;567
3426;42626758;3525;1339;603;736
3427;43821022;3526;1478;606;872
3428;32960387;3527;1089;534;555
3429;21117696;3528;634;254;380
3430;42181122;3529;1156;474;682
3431;32798894;3530;1392;627;765
3432;40369084;3531;762;305;457
3433;32956415;3532;961;491;470
3434;32964104;3533;1426;671;755
3435;8640374;3534;623;281;342
3436;32543101;3535;1459;657;802
3437;40444332;3536;907;427;480
3438;32847131;3537;832;350;482
3439;44968358;3538;1355;664;691
3440;17893944;3539;1031;403;628
3441;32962173;3540;918;414;504
3442;80249564;3541;815;326;489
3443;44356655;3542;1341;550;791
3444;32968900;3543;1007;434;573
3445;41524023;3544;1456;627;829
3446;22464509;3545;829;332;497
3447;45301160;3546;1222;575;647
3448;32823011;3547;912;411;501
3449;15610280;3548;1231;542;689
3450;32908017;3549;971;399;572
3451;32933375;3550;1065;469;596
3452;80249507;3551;1308;628;680
3453;32869502;3552;982;501;481
3454;32853316;3553;798;376;422
3455;80197623;3554;886;390;496
3456;42587414;3555;1269;521;748
3457;32940195;3556;1104;530;574
3458;32956667;3557;802;385;417
3459;32845918;3558;731;300;431
3460;32930279;3559;828;365;463
3461;32761042;3560;1312;565;747
3462;32910175;3561;517;228;289
3463;46317155;3562;759;312;447
3464;43088986;3563;1424;698;726
3465;43871476;3564;1435;560;875
3466;45102836;3565;714;293;421
3467;32733946;3566;860;379;481
3468;45972021;3567;817;344;473
3469;42847278;3568;1253;552;701
3470;48014302;3569;992;496;496
3471;32956081;3570;751;361;390
3472;42821201;3571;507;198;309
3473;48639631;3572;1095;537;558
3474;32944252;3573;1168;514;654
3475;47729366;3574;1409;663;746
3476;73376175;3575;520;250;270
3477;42751667;3576;1468;617;851
3478;32931306;3577;710;306;404
3479;32885836;3578;766;345;421
3480;42485218;3579;674;317;357
3481;32958689;3580;1212;485;727
3482;32739124;3581;555;278;277
3483;32839687;3582;1233;543;690
3484;32818844;3583;1337;589;748
3485;44606923;3584;683;281;402
3486;32801719;3585;1360;544;816
3487;32842335;3586;1224;478;746
3488;32395384;3587;805;347;458
3489;32791135;3588;1235;606;629
3490;32949302;3589;1461;702;759
3491;32866904;3590;665;273;392
3492;32797659;3591;870;427;443
3493;32899833;3592;972;448;524
3494;32808208;3593;953;420;533
3495;40244688;3594;997;489;508
3496;73079437;3595;518;265;253
3497;32807950;3596;1042;501;541
3498;32940926;3597;1473;708;765
3499;32807066;3598;1062;531;531
3500;32865066;3599;593;273;320
3501;32797708;3600;1326;557;769
3502;32124330;3601;1485;669;816
3503;40154385;3602;642;315;327
3504;32814476;3603;1223;526;697
3505;32765421;3604;1367;657;710
3506;44549373;3605;1114;502;612
3507;32988398;3606;504;207;297
3508;32979760;3607;1303;535;768
3509;32958521;3608;1313;513;800
3510;32846679;3609;566;227;339
3511;2698005;3610;1040;437;603
3512;83865678;3611;580;227;353
3513;80180706;3612;1464;586;878
3514;80180807;3613;574;265;309
3515;21970965;3614;1405;562;843
3516;32797709;3615;1457;671;786
3517;32911900;3616;1415;637;778
3518;93521008;3617;765;314;451
3519;21574282;3618;1333;667;666
3520;32953161;3619;764;352;412
3521;45649268;3620;1116;436;680
3522;32983989;3621;536;268;268
3523;32739469;3622;1033;476;557
3524;32937377;3623;870;348;522
3525;32965141;3624;836;335;501
3526;42663419;3625;636;325;311
3527;32910119;3626;2586;1216;1370
3528;40333486;3627;2679;1099;1580
3529;46008614;3628;2072;850;1222
3530;46286343;3629;1971;868;1103
3531;80210120;3630;1517;668;849
3532;42896467;3631;2664;1279;1385
3533;32904933;3632;1973;869;1104
3534;32943793;3633;1516;683;833
3535;35278899;3634;2060;989;1071
3536;32796363;3635;2024;810;1214
3537;40271678;3636;1972;1006;966
3538;32986628;3637;2758;1269;1489
3539;9476167;3638;2605;1225;1380
3540;41092778;3639;1766;795;971
3541;32962083;3640;601;301;300
3542;44225272;3641;1282;641;641
3543;32910648;3642;962;472;490
3544;32886290;3643;1193;525;668
3545;32972562;3644;1047;461;586
3546;969299;3645;1313;618;695
3547;40600577;3646;1386;610;776
3548;32895753;3647;955;411;544
3549;32951973;3648;667;314;353
3550;41873511;3649;796;398;398
3551;40255443;3650;703;352;351
3552;32958690;3651;687;330;357
3553;32856235;3652;933;467;466
3554;40701771;3653;706;276;430
3555;32909516;3654;770;370;400
3556;93116432;3655;1103;453;650
3557;43023338;3656;1455;728;727
3558;32862573;3657;943;434;509
3559;33265487;3658;735;309;426
3560;32927610;3659;936;412;524
3561;32739823;3660;1429;686;743
3562;43740898;3661;1497;704;793
3563;32841386;3662;734;316;418
3564;32805655;3663;1051;410;641
3565;32760201;3664;748;292;456
3566;32842753;3665;896;350;546
3567;41343129;3666;524;252;272
3568;32866291;3667;873;420;453
3569;32848396;3668;646;298;348
3570;32760495;3669;1426;656;770
3571;32762537;3670;747;307;440
3572;32941405;3671;1466;572;894
3573;32923418;3672;1255;590;665
3574;32938994;3673;777;389;388
3575;32790541;3674;914;457;457
3576;40233237;3675;732;301;431
3577;32740743;3676;1048;430;618
3578;32923344;3677;1146;482;664
3579;40081656;3678;1386;583;803
3580;32814431;3679;1316;566;750
3581;9270584;3680;1064;426;638
3582;80206359;3681;937;403;534
3583;40791604;3682;1248;624;624
3584;32120899;3683;1427;700;727
3585;32123343;3684;1068;534;534
3586;32120540;3685;638;275;363
3587;32118511;3686;1426;557;869
3588;80209350;3687;808;316;492
3589;32116484;3688;1485;654;831
3590;15757070;3689;930;428;502
3591;80249448;3690;965;464;501
3592;40547111;3691;664;259;405
3593;8690986;3692;891;437;454
3594;42859774;3693;526;211;315
3595;32125763;3694;1375;550;825
3596;32108055;3695;520;234;286
3597;32120076;3696;534;251;283
3598;32137418;3697;978;411;567
3599;41810973;3698;1003;502;501
3600;32125436;3699;951;409;542
3601;32124580;3700;1039;478;561
3602;15848357;3701;535;273;262
3603;31616637;3702;1006;463;543
3604;43093369;3703;1288;529;759
3605;32125633;3704;746;359;387
3606;32136075;3705;952;448;504
3607;32124981;3706;785;322;463
3608;32137241;3707;1234;568;666
3609;32125444;3708;729;314;415
3610;32121608;3709;1026;483;543
3611;32120307;3710;925;370;555
3612;32123727;3711;949;437;512
3613;32134926;3712;805;371;434
3614;41359703;3713;1032;506;526
3615;44959915;3714;1185;534;651
3616;31770142;3715;1115;525;590
3617;32119041;3716;747;352;395
3618;32123934;3717;1354;529;825
3619;32117213;3718;1335;548;787
3620;7520873;3719;1182;509;673
3621;32124765;3720;829;415;414
3622;32135337;3721;983;443;540
3623;32117206;3722;832;350;482
3624;47320016;3723;1282;577;705
3625;3885745;3724;1399;686;713
3626;6005984;3725;1101;529;572
3627;32121246;3726;820;369;451
3628;42413023;3727;1065;490;575
3629;76367259;3728;599;246;353
3630;32122949;3729;826;356;470
3631;32125189;3730;858;344;514
3632;44754537;3731;1008;434;574
3633;32135564;3732;768;315;453
3634;42975868;3733;534;267;267
3635;41436193;3734;1250;625;625
3636;73632545;3735;1480;755;725
3637;41174915;3736;1421;612;809
3638;33262178;3737;854;376;478
3639;44963816;3738;968;417;551
3640;32137477;3739;879;396;483
3641;32137258;3740;1073;419;654
3642;46827964;3741;1339;549;790
3643;25778385;3742;863;363;500
3644;25627330;3743;1458;584;874
3645;40035503;3744;553;233;320
3646;32124899;3745;678;346;332
3647;32865576;3746;1088;555;533
3648;32868198;3747;1400;644;756
3649;32969279;3748;839;328;511
3650;32859505;3749;753;362;391
3651;40074336;3750;631;310;321
3652;32809129;3751;509;245;264
3653;33259937;3752;921;360;561
3654;32833370;3753;912;356;556
3655;18162299;3754;1121;460;661
3656;32904968;3755;1234;617;617
3657;32782250;3756;1287;567;720
3658;88989600;3757;1019;408;611
3659;32939405;3758;1391;626;765
3660;32737388;3759;1470;588;882
3661;32732357;3760;535;236;299
3662;43412701;3761;1500;615;885
3663;41281226;3762;584;263;321
3664;32819854;3763;1323;543;780
3665;32919245;3764;1491;716;775
3666;32975189;3765;1222;538;684
3667;32854948;3766;1361;681;680
3668;32867621;3767;663;279;384
3669;32784485;3768;599;246;353
3670;32836156;3769;1238;619;619
3671;32933722;3770;1099;561;538
3672;32919837;3771;1096;472;624
3673;32836391;3772;1097;516;581
3674;32976943;3773;1196;610;586
3675;40797832;3774;559;280;279
3676;32138968;3775;1392;599;793
3677;32973404;3776;1377;689;688
3678;42018112;3777;747;352;395
3679;44828885;3778;1135;500;635
3680;41561427;3779;797;399;398
3681;32904176;3780;954;468;486
3682;43558154;3781;954;411;543
3683;19696866;3782;1324;570;754
3684;80493779;3783;1117;537;580
3685;46495765;3784;1287;528;759
3686;81582873;3785;1188;488;700
3687;43314627;3786;505;238;267
3688;32991407;3787;564;237;327
3689;32809171;3788;686;350;336
3690;32936464;3789;1356;597;759
3691;44863858;3790;528;217;311
3692;45111433;3791;1173;481;692
3693;45066275;3792;1269;597;672
3694;46613687;3793;1487;729;758
3695;18214196;3794;1348;580;768
3696;32859716;3795;1495;763;732
3697;42995483;3796;1394;697;697
3698;32898090;3797;1419;724;695
3699;32891436;3798;930;465;465
3700;32947558;3799;993;447;546
3701;40250905;3800;1396;559;837
3702;80620846;3801;1332;547;785
3703;43987373;3802;1093;481;612
3704;32890810;3803;1216;596;620
3705;32902729;3804;795;374;421
3706;981662;3805;1350;648;702
3707;40179193;3806;1197;563;634
3708;32895851;3807;1219;561;658
3709;32946283;3808;1382;691;691
3710;32984229;3809;1241;609;632
3711;42817988;3810;541;233;308
3712;32898246;3811;977;411;566
3713;41310832;3812;666;320;346
3714;41286392;3813;1491;686;805
3715;3615119;3814;1461;702;759
3716;43052627;3815;1338;656;682
3717;32139203;3816;1247;562;685
3718;32896702;3817;984;463;521
3719;43457736;3818;1450;595;855
3720;32890877;3819;922;369;553
3721;80260142;3820;1447;724;723
3722;32890496;3821;1279;550;729
3723;18119869;3822;688;289;399
3724;43857959;3823;1109;500;609
3725;32903047;3824;1062;510;552
3726;32139332;3825;915;366;549
3727;32966168;3826;1223;539;684
3728;32814204;3827;588;271;317
3729;43809183;3828;626;295;331
3730;43826817;3829;652;261;391
3731;32891488;3830;671;329;342
3732;80275161;3831;504;237;267
3733;32902295;3832;767;300;467
3734;32893893;3833;1043;439;604
3735;46506414;3834;1239;521;718
3736;43844670;3835;1017;468;549
3737;32872821;3836;1263;619;644
3738;32984311;3837;839;420;419
3739;32893509;3838;976;420;556
3740;32889442;3839;1025;431;594
3741;42181103;3840;888;418;470
3742;47066598;3841;750;330;420
3743;43458453;3842;964;425;539
3744;32893978;3843;1314;631;683
3745;45768637;3844;1195;502;693
3746;32946400;3845;871;375;496
3747;70131021;3846;720;339;381
3748;43089000;3847;1061;414;647
3749;70131020;3848;1012;436;576
3750;70127222;3849;1449;725;724
3751;70130470;3850;536;242;294
3752;70152825;3851;843;329;514
3753;32900816;3852;1325;663;662
3754;32946178;3853;519;208;311
3755;32992638;3854;945;378;567
3756;32902589;3855;1297;597;700
3757;31676676;3856;582;251;331
3758;32972002;3857;1493;613;880
3759;32946158;3858;1183;545;638
3760;32538420;3859;1136;512;624
3761;32901514;3860;786;370;416
3762;32735951;3861;838;419;419
3763;32903671;3862;654;301;353
3764;32892422;3863;940;405;535
3765;32893519;3864;996;498;498
3766;80614080;3865;1336;522;814
3767;32892471;3866;756;333;423
3768;32528630;3867;542;255;287
3769;32874882;3868;608;244;364
3770;32893465;3869;596;233;363
3771;10034753;3870;901;370;531
3772;32981689;3871;593;297;296
3773;32893463;3872;961;433;528
3774;32938288;3873;630;322;308
3775;42242521;3874;1499;645;854
3776;43165302;3875;1250;500;750
3777;43112584;3876;1155;532;623
3778;32896762;3877;501;256;245
3779;32953406;3878;905;435;470
3780;80192721;3879;1290;568;722
3781;44597148;3880;1379;690;689
3782;32895252;3881;1164;571;593
3783;32901765;3882;765;322;443
3784;32856604;3883;623;293;330
3785;32892148;3884;541;255;286
3786;32734674;3885;1340;630;710
3787;40661251;3886;1390;668;722
3788;32894598;3887;1017;438;579
3789;32893263;3888;569;268;301
3790;32739881;3889;554;222;332
3791;32946982;3890;1142;549;593
3792;32734426;3891;1122;449;673
3793;44054792;3892;977;411;566
3794;43983607;3893;1218;524;694
3795;42887707;3894;1418;639;779
3796;32914181;3895;623;293;330
3797;32872808;3896;677;339;338
3798;70225827;3897;1282;526;756
3799;32962114;3898;988;415;573
3800;44154819;3899;535;236;299
3801;40167600;3900;1086;489;597
3802;45627556;3901;591;272;319
3803;47285910;3902;680;279;401
3804;41872928;3903;1104;508;596
3805;70267944;3904;621;268;353
3806;44383785;3905;642;257;385
3807;32900439;3906;711;313;398
3808;40349645;3907;1089;501;588
3809;70012578;3908;1027;473;554
3810;76673985;3909;641;250;391
3811;32858971;3910;629;265;364
3812;32893345;3911;1072;526;546
3813;41053284;3912;1303;652;651
3814;70308004;3913;1239;583;656
3815;70262132;3914;1021;429;592
3816;70288536;3915;830;391;439
3817;45863448;3916;891;348;543
3818;70225849;3917;595;250;345
3819;32911244;3918;1266;507;759
3820;70264891;3919;872;384;488
3821;43515530;3920;771;324;447
3822;41839436;3921;1258;579;679
3823;76573652;3922;1155;474;681
3824;32947068;3923;1449;566;883
3825;32896265;3924;642;264;378
3826;40352069;3925;952;448;504
3827;44507658;3926;597;269;328
3828;32872917;3927;1082;498;584
3829;32901444;3928;714;286;428
3830;32812856;3929;599;252;347
3831;42133025;3930;1066;480;586
3832;41786746;3931;1270;610;660
3833;32792875;3932;687;282;405
3834;32910968;3933;820;386;434
3835;32942150;3934;992;427;565
3836;32897977;3935;880;423;457
3837;42332836;3936;1361;681;680
3838;80275265;3937;1407;620;787
3839;32921168;3938;1422;598;824
3840;40365142;3939;1491;597;894
3841;32899663;3940;1293;582;711
3842;32893286;3941;1037;478;559
3843;33261700;3942;1156;451;705
3844;44627622;3943;1231;604;627
3845;32919097;3944;1184;521;663
3846;32857132;3945;1031;444;587
3847;32895895;3946;1074;419;655
3848;32953593;3947;1438;648;790
3849;32895709;3948;509;250;259
3850;32896627;3949;1144;561;583
3851;32898212;3950;507;203;304
3852;32899857;3951;762;374;388
3853;45532602;3952;702;288;414
3854;32900683;3953;694;292;402
3855;32898927;3954;578;237;341
3856;45242176;3955;730;365;365
3857;32869423;3956;716;358;358
3858;32946211;3957;1312;643;669
3859;32902001;3958;710;284;426
3860;32900519;3959;1421;612;809
3861;32896642;3960;712;364;348
3862;44022157;3961;960;423;537
3863;44596113;3962;711;299;412
3864;11149680;3963;924;398;526
3865;32829592;3964;1388;570;818
3866;40364779;3965;656;283;373
3867;32946786;3966;533;267;266
3868;45484130;3967;821;370;451
3869;80103087;3968;845;389;456
3870;32968619;3969;999;480;519
3871;70121072;3970;1375;550;825
3872;45996034;3971;686;295;391
3873;41923928;3972;1412;721;691
3874;43985164;3973;631;284;347
3875;32898308;3974;879;422;457
3876;43023160;3975;572;241;331
3877;70179372;3976;1214;547;667
3878;32893494;3977;1346;673;673
3879;70179531;3978;602;277;325
3880;45763636;3979;875;350;525
3881;42105055;3980;768;354;414
3882;42838744;3981;644;297;347
3883;42447499;3982;765;375;390
3884;43484955;3983;1212;570;642
3885;32992607;3984;1228;529;699
3886;70182654;3985;1179;566;613
3887;43282988;3986;1051;431;620
3888;70013083;3987;777;350;427
3889;79148978;3988;864;424;440
3890;40433361;3989;1275;574;701
3891;32890984;3990;1404;548;856
3892;71462566;3991;1039;478;561
3893;32916097;3992;975;390;585
3894;45059218;3993;997;469;528
3895;76857549;3994;1294;570;724
3896;32900887;3995;629;290;339
3897;46152036;3996;1401;547;854
3898;32734689;3997;611;294;317
3899;32891213;3998;1010;404;606
3900;73376587;3999;1239;632;607
3901;33811289;4000;1493;702;791
3902;32890994;4001;1050;483;567
3903;70004079;4002;1424;627;797
3904;70179530;4003;574;282;292
3905;40738804;4004;1105;564;541
3906;32900116;4005;1358;598;760
3907;32938554;4006;711;342;369
3908;32947354;4007;1433;588;845
3909;42180935;4008;706;346;360
3910;32947344;4009;575;248;327
3911;32889770;4010;1431;573;858
3912;32890981;4011;664;332;332
3913;32895664;4012;915;412;503
3914;32902291;4013;808;348;460
3915;32984310;4014;963;424;539
3916;32763905;4015;877;439;438
3917;32897215;4016;663;266;397
3918;17882873;4017;828;332;496
3919;44333936;4018;1466;616;850
3920;43240811;4019;922;452;470
3921;32984161;4020;1148;529;619
3922;32899726;4021;735;339;396
3923;32889307;4022;1114;546;568
3924;32937854;4023;1395;656;739
3925;32893802;4024;696;314;382
3926;6315085;4025;611;294;317
3927;32947086;4026;1076;463;613
3928;18189822;4027;754;347;407
3929;40163981;4028;594;256;338
3930;32902804;4029;1434;732;702
3931;41456098;4030;1240;596;644
3932;32893214;4031;685;268;417
3933;32893706;4032;955;468;487
3934;42405821;4033;1191;572;619
3935;80110697;4034;719;353;366
3936;42525340;4035;1367;561;806
3937;32947639;4036;816;360;456
3938;32891380;4037;1457;569;888
3939;42881427;4038;1437;662;775
3940;28102599;4039;1073;462;611
3941;32984077;4040;1368;671;697
3942;47285997;4041;761;305;456
3943;32921315;4042;674;324;350
3944;32899812;4043;764;306;458
3945;40539626;4044;918;404;514
3946;32918140;4045;643;316;327
3947;32911877;4046;630;278;352
3948;32980193;4047;920;396;524
3949;32794950;4048;1408;690;718
3950;32907911;4049;525;258;267
3951;57786433;4050;867;382;485
3952;88936517;4051;720;332;388
3953;10125951;4052;1404;576;828
3954;32739798;4053;1184;510;674
3955;42586940;4054;901;451;450
3956;15697137;4055;2984;1313;1671
3957;41500945;4056;1949;994;955
3958;31671047;4057;2498;975;1523
3959;40972214;4058;2864;1117;1747
3960;32866335;4059;1560;671;889
3961;32104886;4060;2824;1158;1666
3962;32105593;4061;2972;1219;1753
3963;41288819;4062;2056;967;1089
3964;32131161;4063;2827;1188;1639
3965;41789209;4064;2842;1223;1619
3966;32887159;4065;1923;962;961
3967;32106711;4066;2391;957;1434
3968;41535748;4067;2825;1272;1553
3969;32101584;4068;2939;1147;1792
3970;32105985;4069;2766;1273;1493
3971;43436766;4070;1855;872;983
3972;43059283;4071;2119;975;1144
3973;32110105;4072;2334;981;1353
3974;32111472;4073;2943;1207;1736
3975;32106802;4074;1894;796;1098
3976;32132318;4075;2828;1245;1583
3977;32952014;4076;2285;983;1302
3978;32111218;4077;2311;1179;1132
3979;41978056;4078;1568;612;956
3980;32100317;4079;2437;975;1462
3981;32105898;4080;2193;943;1250
3982;42492186;4081;2221;1133;1088
3983;32104395;4082;2518;1159;1359
3984;32130937;4083;1574;787;787
3985;80268792;4084;2812;1378;1434
3986;32104962;4085;2317;1043;1274
3987;8053582;4086;1532;659;873
3988;21417345;4087;2116;1037;1079
3989;7637670;4088;2745;1263;1482
3990;41128685;4089;2744;1400;1344
3991;71051877;4090;1861;801;1060
3992;47800217;4091;1914;804;1110
3993;43219805;4092;2765;1272;1493
3994;32108022;4093;1886;849;1037
3995;48237236;4094;2266;1043;1223
3996;39414561;4095;2621;1049;1572
3997;71739643;4096;2974;1398;1576
3998;9398685;4097;2725;1390;1335
3999;32139190;4098;2999;1500;1499
4000;32954833;4099;2910;1310;1600
4001;32957151;4100;1607;820;787
4002;32977480;4101;1753;807;946
4003;19424482;4102;2354;1201;1153
4004;44798498;4103;2487;1145;1342
4005;44154856;4104;2095;859;1236
4006;40612351;4105;2216;865;1351
4007;32978169;4106;2228;1003;1225
4008;32959505;4107;1788;877;911
4009;32832085;4108;2180;916;1264
4010;32955125;4109;2649;1325;1324
4011;32926035;4110;2189;1073;1116
4012;32861996;4111;2305;992;1313
4013;45323886;4112;2226;1113;1113
4014;3681623;4113;2522;1110;1412
4015;32992457;4114;2287;938;1349
4016;43026601;4115;2977;1400;1577
4017;32980000;4116;2777;1111;1666
4018;33263602;4117;2612;1254;1358
4019;32884842;4118;1526;748;778
4020;18054147;4119;2567;1181;1386
4021;32952561;4120;2265;974;1291
4022;32814715;4121;2540;1296;1244
4023;43180179;4122;2229;1026;1203
4024;32955083;4123;1823;821;1002
4025;32260008;4124;2740;1151;1589
4026;32849418;4125;2321;1022;1299
4027;32982808;4126;2174;1087;1087
4028;44427464;4127;2619;1100;1519
4029;32732200;4128;1851;796;1055
4030;32847968;4129;1952;879;1073
4031;32897988;4130;2345;1150;1195
4032;45866219;4131;2047;860;1187
4033;41849123;4132;2064;888;1176
4034;32928141;4133;2721;1143;1578
4035;32983013;4134;2593;1167;1426
4036;40094908;4135;1556;778;778
4037;32856864;4136;1562;703;859
4038;80560655;4137;2174;1066;1108
4039;92445897;4138;2459;1009;1450
4040;46047799;4139;2285;1143;1142
4041;32542838;4140;2516;1007;1509
4042;45094894;4141;1742;889;853
4043;32940387;4142;1088;534;554
4044;53396280;4143;1077;496;581
4045;32791952;4144;1011;455;556
4046;32541601;4145;852;392;460
4047;32898572;4146;773;325;448
4048;32941994;4147;980;471;509
4049;33265389;4148;892;375;517
4050;42480135;4149;509;224;285
4051;32393653;4150;1360;694;666
4052;32831749;4151;707;312;395
4053;32955470;4152;1113;446;667
4054;41806407;4153;1244;573;671
4055;46281918;4154;1326;531;795
4056;32955919;4155;506;208;298
4057;32738641;4156;874;411;463
4058;41028877;4157;1292;504;788
4059;72942036;4158;1081;519;562
4060;47973470;4159;648;331;317
4061;32542240;4160;844;347;497
4062;32785874;4161;725;290;435
4063;43115396;4162;548;264;284
4064;45246947;4163;1321;621;700
4065;32763413;4164;663;339;324
4066;45436398;4165;967;494;473
4067;47122917;4166;1405;562;843
4068;41087111;4167;786;315;471
4069;80333189;4168;954;430;524
4070;76979532;4169;1076;431;645
4071;70878385;4170;728;292;436
4072;74322175;4171;984;384;600
4073;44496270;4172;1265;557;708
4074;76195131;4173;916;413;503
4075;70334088;4174;1406;647;759
4076;74146562;4175;727;320;407
4077;42997977;4176;1217;487;730
4078;32864443;4177;620;317;303
4079;32952160;4178;1013;436;577
4080;33265913;4179;1092;437;655
4081;32887289;4180;986;454;532
4082;32774299;4181;1321;582;739
4083;32886817;4182;1206;495;711
4084;33265887;4183;750;338;412
4085;33575631;4184;581;239;342
4086;41066370;4185;511;251;260
4087;42258007;4186;537;269;268
4088;33264128;4187;1070;503;567
4089;32886875;4188;1241;484;757
4090;32887524;4189;1419;625;794
4091;32886899;4190;1168;491;677
4092;32931387;4191;1030;474;556
4093;40399110;4192;1314;592;722
4094;43140081;4193;722;361;361
4095;32886623;4194;574;247;327
4096;42999811;4195;1203;518;685
4097;95744449;4196;920;433;487
4098;32952169;4197;625;294;331
4099;32887069;4198;635;261;374
4100;49085751;4199;1290;581;709
4101;32886469;4200;1048;504;544
4102;24713015;4201;868;365;503
4103;32887373;4202;876;430;446
4104;43281981;4203;1232;616;616
4105;32941184;4204;664;266;398
4106;40034797;4205;964;386;578
4107;32887505;4206;702;316;386
4108;41349626;4207;725;334;391
4109;41331269;4208;1402;575;827
4110;41664338;4209;894;412;482
4111;44704459;4210;1176;471;705
4112;28104909;4211;641;250;391
4113;43341752;4212;770;393;377
4114;45632729;4213;1310;603;707
4115;40605471;4214;555;234;321
4116;16670281;4215;1159;499;660
4117;33338439;4216;1415;623;792
4118;33265844;4217;1006;433;573
4119;46136268;4218;1254;552;702
4120;3693663;4219;593;273;320
4121;42485684;4220;618;309;309
4122;32887587;4221;1059;509;550
4123;32993011;4222;683;301;382
4124;32887220;4223;977;411;566
4125;33262602;4224;1028;494;534
4126;46706748;4225;1334;574;760
4127;47381719;4226;1419;596;823
4128;47947039;4227;641;295;346
4129;32867631;4228;673;276;397
4130;46002167;4229;802;337;465
4131;32952006;4230;1217;585;632
4132;80200232;4231;1017;468;549
4133;32867724;4232;726;327;399
4134;47680368;4233;1018;398;620
4135;43750749;4234;1218;561;657
4136;33265835;4235;733;367;366
4137;47108914;4236;641;283;358
4138;44989921;4237;702;323;379
4139;46228978;4238;840;336;504
4140;48337494;4239;984;394;590
4141;18865968;4240;1044;481;563
4142;32952013;4241;1418;653;765
4143;41258870;4242;1437;662;775
4144;43541576;4243;687;344;343
4145;40691658;4244;950;437;513
4146;32887477;4245;679;326;353
4147;80239096;4246;943;387;556
4148;32887247;4247;847;399;448
4149;48346719;4248;946;455;491
4150;70187621;4249;1048;462;586
4151;45202446;4250;1342;524;818
4152;44873574;4251;833;334;499
4153;73313996;4252;919;432;487
4154;9943974;4253;1204;578;626
4155;32881570;4254;1383;609;774
4156;32988246;4255;997;399;598
4157;19680207;4256;945;378;567
4158;32971405;4257;998;390;608
4159;32904653;4258;1279;627;652
4160;32978152;4259;505;218;287
4161;32927433;4260;1280;628;652
4162;43985174;4261;1469;691;778
4163;32542073;4262;1072;494;578
4164;42562143;4263;962;472;490
4165;41704803;4264;1038;499;539
4166;40177317;4265;1293;634;659
4167;45307952;4266;1435;574;861
4168;70440423;4267;835;393;442
4169;44568382;4268;540;222;318
4170;32978153;4269;890;437;453
4171;33264765;4270;926;417;509
4172;62138080;4271;978;392;586
4173;10833044;4272;705;346;359
4174;45910135;4273;1298;572;726
4175;46561153;4274;1221;538;683
4176;32863473;4275;1288;619;669
4177;47103919;4276;844;338;506
4178;47176476;4277;584;257;327
4179;33264908;4278;1254;490;764
4180;32775689;4279;554;272;282
4181;44444147;4280;738;296;442
4182;40120301;4281;1283;604;679
4183;31139198;4282;851;366;485
4184;19424474;4283;983;472;511
4185;43327831;4284;740;370;370
4186;32960864;4285;1326;597;729
4187;32912181;4286;505;213;292
4188;47548463;4287;948;465;483
4189;44568918;4288;1008;404;604
4190;18872724;4289;644;265;379
4191;45600317;4290;1059;424;635
4192;40130531;4291;694;341;353
4193;45388603;4292;1014;477;537
4194;70936152;4293;845;347;498
4195;32865245;4294;802;353;449
4196;32991074;4295;1087;435;652
4197;32138850;4296;1407;620;787
4198;32791314;4297;994;458;536
4199;41674468;4298;1045;460;585
4200;32826033;4299;662;285;377
4201;32925990;4300;1161;523;638
4202;32778806;4301;1404;702;702
4203;32915384;4302;858;421;437
4204;32953498;4303;1123;483;640
4205;32988299;4304;1268;584;684
4206;32988078;4305;991;387;604
4207;41014375;4306;603;236;367
4208;40389064;4307;695;292;403
4209;32790428;4308;1237;495;742
4210;42517777;4309;643;258;385
4211;8936127;4310;869;383;486
4212;42449133;4311;1498;645;853
4213;32951081;4312;874;394;480
4214;32941675;4313;1403;674;729
4215;32841809;4314;1422;655;767
4216;40005673;4315;645;252;393
4217;32978878;4316;909;391;518
4218;32970479;4317;577;243;334
4219;43173757;4318;921;397;524
4220;32986282;4319;534;251;283
4221;40285029;4320;506;259;247
4222;41470365;4321;892;384;508
4223;45125136;4322;1092;481;611
4224;32983614;4323;720;346;374
4225;43399505;4324;1204;494;710
4226;32946406;4325;954;392;562
4227;32962099;4326;874;411;463
4228;43555168;4327;683;328;355
4229;44239357;4328;629;277;352
4230;40849358;4329;804;322;482
4231;42803284;4330;840;378;462
4232;40467001;4331;609;287;322
4233;32952945;4332;1121;561;560
4234;32845639;4333;598;270;328
4235;18176363;4334;1107;510;597
4236;72049504;4335;781;399;382
4237;40473934;4336;1204;482;722
4238;46895504;4337;1419;710;709
4239;32906885;4338;1153;542;611
4240;75410771;4339;832;400;432
4241;47450486;4340;1150;552;598
4242;32541574;4341;772;348;424
4243;43136183;4342;1486;729;757
4244;32842399;4343;775;388;387
4245;72778532;4344;587;235;352
4246;40511139;4345;537;264;273
4247;32971266;4346;593;303;290
4248;32853203;4347;1113;479;634
4249;32949871;4348;712;300;412
4250;80325608;4349;1017;438;579
4251;32886837;4350;751;316;435
4252;32932815;4351;1419;653;766
4253;32953738;4352;956;392;564
4254;32952833;4353;741;312;429
4255;32952657;4354;1464;659;805
4256;32804465;4355;1158;533;625
4257;32844600;4356;663;319;344
4258;32541135;4357;1139;524;615
4259;78215626;4358;1293;518;775
4260;32949282;4359;780;336;444
4261;45467878;4360;1409;564;845
4262;89703044;4361;1210;497;713
4263;81124069;4362;1032;496;536
4264;41256815;4363;837;352;485
4265;32771287;4364;1187;523;664
4266;45350824;4365;602;301;301
4267;42285098;4366;1015;467;548
4268;44295879;4367;1367;629;738
4269;33264903;4368;1367;602;765
4270;32928663;4369;1262;619;643
4271;32803582;4370;885;381;504
4272;32990222;4371;781;313;468
4273;32949870;4372;1445;723;722
4274;17436279;4373;737;295;442
4275;32982219;4374;512;221;291
4276;32888298;4375;593;273;320
4277;32958508;4376;1343;538;805
4278;42324287;4377;979;441;538
4279;32982994;4378;1085;521;564
4280;7035006;4379;885;372;513
4281;33264218;4380;1219;561;658
4282;36336645;4381;826;413;413
4283;48451731;4382;758;342;416
4284;49811021;4383;1379;566;813
4285;32847021;4384;734;338;396
4286;40588781;4385;1418;695;723
4287;40652570;4386;1073;451;622
4288;32859133;4387;579;261;318
4289;32938775;4388;538;243;295
4290;44392777;4389;534;257;277
4291;71724054;4390;1189;524;665
4292;32738938;4391;1236;594;642
4293;44781100;4392;1466;616;850
4294;32739120;4393;1357;543;814
4295;86650589;4394;832;375;457
4296;32856621;4395;1191;548;643
4297;43170082;4396;551;248;303
4298;59212128;4397;997;459;538
4299;40060989;4398;614;289;325
4300;32802471;4399;790;356;434
4301;32959535;4400;1165;560;605
4302;40012662;4401;819;377;442
4303;42756260;4402;1029;505;524
4304;46592242;4403;826;413;413
4305;41514156;4404;1490;760;730
4306;42159489;4405;914;430;484
4307;32837709;4406;1011;425;586
4308;32916744;4407;957;469;488
4309;32808631;4408;1456;641;815
4310;45998788;4409;637;313;324
4311;32875462;4410;1211;533;678
4312;44007482;4411;656;328;328
4313;32899538;4412;1336;535;801
4314;32969990;4413;1481;756;725
4315;32542435;4414;1448;638;810
4316;32913601;4415;638;300;338
4317;44685231;4416;557;240;317
4318;32784162;4417;1094;493;601
4319;43625210;4418;735;331;404
4320;32794195;4419;1117;570;547
4321;32860660;4420;827;406;421
4322;32960109;4421;968;494;474
4323;43248747;4422;562;281;281
4324;32845280;4423;1325;663;662
4325;71418084;4424;742;327;415
4326;32916138;4425;553;266;287
4327;32948710;4426;642;309;333
4328;32805519;4427;781;368;413
4329;32541119;4428;1357;570;787
4330;33264874;4429;1266;596;670
4331;32855052;4430;676;305;371
4332;45815422;4431;1148;471;677
4333;32978765;4432;1149;541;608
4334;17870434;4433;1494;583;911
4335;46045013;4434;1198;576;622
4336;44667627;4435;1067;502;565
4337;32905120;4436;639;320;319
4338;32542868;4437;979;490;489
4339;32938665;4438;607;262;345
4340;32832130;4439;915;357;558
4341;17854863;4440;807;380;427
4342;32966295;4441;1322;635;687
4343;32521660;4442;897;440;457
4344;46531815;4443;1199;528;671
4345;32974850;4444;1054;475;579
4346;32775899;4445;1097;527;570
4347;82193888;4446;658;277;381
4348;32951529;4447;649;306;343
4349;32930811;4448;919;414;505
4350;71910885;4449;586;288;298
4351;32940254;4450;662;279;383
4352;25851770;4451;1153;462;691
4353;32541347;4452;1462;702;760
4354;47357908;4453;599;276;323
4355;43328620;4454;1405;619;786
4356;41088655;4455;911;410;501
4357;80204824;4456;749;368;381
4358;42639764;4457;1369;671;698
4359;32931315;4458;594;238;356
4360;26673810;4459;1025;513;512
4361;32739495;4460;679;279;400
4362;48108649;4461;584;287;297
4363;40885589;4462;787;386;401
4364;32852239;4463;1302;508;794
4365;32872678;4464;555;222;333
4366;95182866;4465;1425;670;755
4367;32963375;4466;534;209;325
4368;32926516;4467;564;277;287
4369;46298307;4468;766;353;413
4370;32973694;4469;751;376;375
4371;24311641;4470;529;212;317
4372;80207230;4471;633;260;373
4373;48489755;4472;1451;726;725
4374;40079459;4473;733;323;410
4375;48108572;4474;1145;573;572
4376;32867826;4475;655;335;320
4377;72533458;4476;1410;691;719
4378;44791140;4477;967;484;483
4379;32795887;4478;917;386;531
4380;32917282;4479;556;245;311
4381;44158087;4480;629;271;358
4382;46092608;4481;692;284;408
4383;45074548;4482;1410;649;761
4384;41921853;4483;1216;523;693
4385;32885736;4484;1262;543;719
4386;46344058;4485;1326;624;702
4387;32971547;4486;1217;475;742
4388;43844659;4487;939;395;544
4389;43178002;4488;714;293;421
4390;32919959;4489;786;315;471
4391;47039620;4490;1249;550;699
4392;44781700;4491;511;205;306
4393;80206631;4492;847;365;482
4394;23154009;4493;797;351;446
4395;38501641;4494;981;462;519
4396;32779778;4495;796;343;453
4397;32986599;4496;507;249;258
4398;16273600;4497;871;401;470
4399;32862706;4498;1065;544;521
4400;32910482;4499;577;231;346
4401;32790222;4500;809;397;412
4402;32814001;4501;1014;396;618
4403;32773525;4502;687;323;364
4404;45018634;4503;844;338;506
4405;41298047;4504;1177;565;612
4406;10749869;4505;1190;500;690
4407;32913114;4506;847;432;415
4408;32944671;4507;1451;595;856
4409;40553207;4508;1353;569;784
4410;32857273;4509;1413;608;805
4411;40923491;4510;618;266;352
4412;32855817;4511;1498;675;823
4413;32839825;4512;1205;470;735
4414;17927030;4513;1450;595;855
4415;43853775;4514;645;258;387
4416;45019821;4515;655;269;386
4417;32913335;4516;1024;482;542
4418;41190204;4517;1097;560;537
4419;32732643;4518;646;272;374
4420;32939101;4519;1302;573;729
4421;46270948;4520;1381;581;800
4422;32866446;4521;1232;555;677
4423;45904872;4522;1472;663;809
4424;32827419;4523;754;377;377
4425;80387588;4524;891;419;472
4426;32837142;4525;1100;550;550
4427;44237906;4526;880;432;448
4428;32917069;4527;1023;440;583
4429;93580185;4528;529;233;296
4430;26674696;4529;1500;690;810
4431;32823292;4530;1450;653;797
4432;92853854;4531;581;279;302
4433;4826820;4532;1073;451;622
4434;32739257;4533;576;288;288
4435;32944506;4534;780;390;390
4436;32767713;4535;1498;749;749
4437;32977383;4536;1489;745;744
4438;32534489;4537;1217;487;730
4439;32977184;4538;1095;471;624
4440;33240396;4539;1340;563;777
4441;32817050;4540;1182;544;638
4442;26195216;4541;541;239;302
4443;32964301;4542;925;417;508
4444;18011014;4543;990;495;495
4445;33265306;4544;1428;700;728
4446;40326033;4545;1439;605;834
4447;99002709;4546;861;422;439
4448;32543066;4547;715;358;357
4449;32937356;4548;1023;481;542
4450;47069357;4549;991;397;594
4451;32979106;4550;1196;598;598
4452;32925169;4551;626;288;338
4453;32888202;4552;1169;538;631
4454;32951191;4553;1120;504;616
4455;10346912;4554;880;414;466
4456;40365158;4555;1488;744;744
4457;10134252;4556;1287;515;772
4458;32976716;4557;1330;665;665
4459;32820057;4558;1479;651;828
4460;18202320;4559;1117;548;569
4461;46650400;4560;1081;530;551
4462;32964060;4561;702;274;428
4463;32541452;4562;899;414;485
4464;46374857;4563;1452;697;755
4465;17869506;4564;1334;654;680
4466;32979339;4565;1203;506;697
4467;32960625;4566;1139;547;592
4468;40143833;4567;1210;545;665
4469;32982730;4568;869;383;486
4470;40148217;4569;973;448;525
4471;31362102;4570;964;482;482
4472;51126238;4571;766;338;428
4473;70012892;4572;1435;574;861
4474;32866266;4573;1200;552;648
4475;32991261;4574;794;334;460
4476;18275551;4575;1035;508;527
4477;32139473;4576;824;347;477
4478;31626754;4577;2709;1192;1517
4479;59880516;4578;1785;750;1035
4480;32949739;4579;2284;1051;1233
4481;42384168;4580;1575;772;803
4482;70012893;4581;2835;1191;1644
4483;41615530;4582;2994;1318;1676
4484;40591274;4583;2985;1254;1731
4485;40203683;4584;2230;982;1248
4486;47581567;4585;1583;792;791
4487;32804733;4586;2631;1290;1341
4488;42087275;4587;2715;1385;1330
4489;74311980;4588;2356;943;1413
4490;45725873;4589;2515;1258;1257
4491;32832214;4590;1582;665;917
4492;32964751;4591;2098;840;1258
4493;32931022;4592;2477;1090;1387
4494;76915800;4593;1983;893;1090
4495;32768540;4594;2364;1088;1276
4496;32924150;4595;2355;966;1389
4497;72017234;4596;1570;660;910
4498;32858162;4597;2586;1138;1448
4499;41515925;4598;2484;1242;1242
4500;41220014;4599;1597;687;910
4501;47487629;4600;1752;789;963
4502;42484750;4601;2922;1169;1753
4503;43770394;4602;1998;860;1138
4504;32980293;4603;2007;984;1023
4505;32982125;4604;2622;1076;1546
4506;47013829;4605;2299;920;1379
4507;32542791;4606;2591;1244;1347
4508;80194963;4607;1629;668;961
4509;32821069;4608;2438;1171;1267
4510;32138779;4609;2190;1117;1073
4511;32798904;4610;1621;746;875
4512;45602506;4611;2111;972;1139
4513;80586424;4612;2825;1159;1666
4514;32888631;4613;2699;1323;1376
4515;43769990;4614;2232;1027;1205
4516;32810795;4615;2659;1277;1382
4517;32909587;4616;1608;724;884
4518;45010943;4617;1922;961;961
4519;32869144;4618;2860;1144;1716
4520;47039911;4619;1946;798;1148
4521;32909114;4620;1802;703;1099
4522;32956467;4621;2200;946;1254
4523;32932867;4622;2655;1089;1566
4524;32844832;4623;1897;892;1005
4525;46816558;4624;796;391;405
4526;43799144;4625;665;320;345
4527;80202347;4626;692;346;346
4528;80242965;4627;875;420;455
4529;80193750;4628;965;425;540
4530;80365612;4629;1304;574;730
4531;32986333;4630;1419;653;766
4532;61817571;4631;1071;504;567
4533;44379361;4632;1190;560;630
4534;45574658;4633;501;201;300
4535;32930184;4634;1136;557;579
4536;70179492;4635;834;384;450
4537;32960754;4636;858;438;420
4538;32801133;4637;902;442;460
4539;32971954;4638;1171;457;714
4540;44980730;4639;508;224;284
4541;42170293;4640;1383;637;746
4542;46666288;4641;792;381;411
4543;7232341;4642;1124;506;618
4544;73677119;4643;1250;525;725
4545;80132264;4644;1248;575;673
4546;32878004;4645;1270;623;647
4547;32877781;4646;817;327;490
4548;32878301;4647;1476;753;723
4549;32823459;4648;759;388;371
4550;32830968;4649;1117;525;592
4551;32933304;4650;866;442;424
4552;32767766;4651;656;269;387
4553;32977265;4652;908;427;481
4554;32933594;4653;1254;640;614
4555;32850131;4654;1334;667;667
4556;33265212;4655;1243;585;658
4557;32973904;4656;919;451;468
4558;9028010;4657;526;258;268
4559;32926578;4658;855;377;478
4560;44001478;4659;1034;486;548
4561;32857222;4660;613;264;349
4562;32978179;4661;1076;495;581
4563;32938004;4662;583;298;285
4564;43097508;4663;1360;558;802
4565;47276200;4664;851;383;468
4566;227921;4665;939;414;525
4567;32857251;4666;1023;440;583
4568;32771293;4667;1436;661;775
4569;32907175;4668;730;292;438
4570;85090801;4669;1453;611;842
4571;33264334;4670;1217;512;705
4572;40470251;4671;1218;512;706
4573;32826635;4672;1447;666;781
4574;32408146;4673;1025;421;604
4575;44993079;4674;1032;424;608
4576;43462135;4675;1466;660;806
4577;46115109;4676;1116;536;580
4578;40928278;4677;1220;525;695
4579;32784656;4678;1384;665;719
4580;15611754;4679;1258;541;717
4581;32121460;4680;1071;450;621
4582;32952559;4681;1205;482;723
4583;32829316;4682;948;446;502
4584;32739386;4683;1476;709;767
4585;32739839;4684;1211;606;605
4586;42038842;4685;1273;599;674
4587;32848150;4686;943;444;499
4588;32798179;4687;503;257;246
4589;32932860;4688;958;489;469
4590;32846694;4689;587;247;340
4591;32764857;4690;1405;562;843
4592;32966022;4691;1237;607;630
4593;32125026;4692;678;312;366
4594;41821195;4693;1161;453;708
4595;32983798;4694;883;371;512
4596;32977094;4695;1014;507;507
4597;38287758;4696;1049;431;618
4598;48434318;4697;1042;490;552
4599;36700493;4698;518;254;264
4600;98796140;4699;1446;651;795
4601;13547316;4700;1158;579;579
4602;32886786;4701;771;332;439
4603;43920219;4702;891;419;472
4604;32967643;4703;1317;514;803
4605;42663413;4704;1004;462;542
4606;40651479;4705;1049;441;608
4607;33265894;4706;947;446;501
4608;32927813;4707;657;303;354
4609;32865004;4708;932;401;531
4610;47658174;4709;1028;514;514
4611;32952022;4710;1213;534;679
4612;32886162;4711;561;236;325
4613;32991040;4712;543;223;320
4614;41658209;4713;1086;467;619
4615;42871228;4714;1409;592;817
4616;32761682;4715;655;295;360
4617;32801251;4716;1253;514;739
4618;42091566;4717;1345;660;685
4619;32887301;4718;1384;568;816
4620;32887559;4719;525;216;309
4621;32887101;4720;829;407;422
4622;41198833;4721;830;324;506
4623;70215650;4722;1339;670;669
4624;44485761;4723;844;363;481
4625;43772796;4724;1178;519;659
4626;25645639;4725;604;266;338
4627;32785837;4726;506;218;288
4628;70185391;4727;1043;439;604
4629;32811844;4728;1064;458;606
4630;41679248;4729;1050;525;525
4631;45824674;4730;1466;719;747
4632;70215667;4731;1368;602;766
4633;40602653;4732;671;302;369
4634;44468131;4733;1408;592;816
4635;42066172;4734;1202;577;625
4636;43163982;4735;777;311;466
4637;76609499;4736;662;338;324
4638;32856627;4737;874;350;524
4639;32938947;4738;960;375;585
4640;32766315;4739;1242;597;645
4641;80411846;4740;967;407;560
4642;32984039;4741;1361;681;680
4643;33359523;4742;1035;466;569
4644;32873091;4743;1011;476;535
4645;32827650;4744;1133;476;657
4646;32910003;4745;657;322;335
4647;32794663;4746;936;440;496
4648;32886726;4747;650;332;318
4649;44040571;4748;707;361;346
4650;43110259;4749;1410;691;719
4651;47461982;4750;1475;738;737
4652;5645737;4751;871;436;435
4653;8839399;4752;1371;576;795
4654;41701839;4753;1255;628;627
4655;47852371;4754;1071;472;599
4656;32863265;4755;702;337;365
4657;32868061;4756;1484;639;845
4658;46580539;4757;1373;687;686
4659;42995142;4758;1189;524;665
4660;32777891;4759;799;352;447
4661;41388053;4760;1253;539;714
4662;80193845;4761;1160;453;707
4663;32900980;4762;1100;495;605
4664;41783107;4763;666;307;359
4665;45240180;4764;629;284;345
4666;44667617;4765;731;351;380
4667;32834587;4766;1323;636;687
4668;32844931;4767;1130;452;678
4669;46875243;4768;1368;534;834
4670;32765517;4769;1189;536;653
4671;32858420;4770;1436;690;746
4672;32846188;4771;1434;574;860
4673;80362485;4772;1337;656;681
4674;43407687;4773;736;324;412
4675;42324460;4774;677;298;379
4676;3846965;4775;898;360;538
4677;33263083;4776;1186;570;616
4678;41359179;4777;1258;604;654
4679;32856183;4778;1420;583;837
4680;77099742;4779;589;260;329
4681;43670415;4780;526;216;310
4682;72627911;4781;506;208;298
4683;77098551;4782;929;437;492
4684;46130791;4783;1215;596;619
4685;46787276;4784;703;303;400
4686;45913075;4785;667;287;380
4687;32973239;4786;1024;420;604
4688;47874282;4787;624;312;312
4689;32928090;4788;896;440;456
4690;32981655;4789;785;393;392
4691;41151831;4790;1295;518;777
4692;41247288;4791;1035;425;610
4693;32792119;4792;1180;590;590
4694;32887907;4793;1290;529;761
4695;46356324;4794;1007;474;533
4696;44669253;4795;938;404;534
4697;32790398;4796;1437;575;862
4698;70118878;4797;613;252;361
4699;47056423;4798;1355;556;799
4700;32940777;4799;589;283;306
4701;32987773;4800;849;340;509
4702;70119255;4801;748;315;433
4703;75287280;4802;1032;475;557
4704;47611046;4803;768;377;391
4705;73378474;4804;1270;623;647
4706;32139532;4805;1311;669;642
4707;41908927;4806;567;239;328
4708;32867136;4807;881;423;458
4709;32865904;4808;1202;505;697
4710;32791933;4809;609;287;322
4711;76249731;4810;1391;682;709
4712;96975112;4811;1060;499;561
4713;95566171;4812;1386;624;762
4714;41736404;4813;1103;442;661
4715;32980159;4814;539;248;291
4716;32772261;4815;956;440;516
4717;46187520;4816;1214;583;631
4718;42483918;4817;1228;516;712
4719;32733510;4818;1131;453;678
4720;44818703;4819;780;367;413
4721;46487723;4820;533;262;271
4722;42044271;4821;1400;700;700
4723;44425587;4822;1235;482;753
4724;7620309;4823;542;217;325
4725;32926653;4824;1262;581;681
4726;44022167;4825;752;361;391
4727;40635614;4826;1270;585;685
4728;32761083;4827;946;436;510
4729;32740043;4828;1163;454;709
4730;32926162;4829;548;225;323
4731;32816722;4830;839;403;436
4732;32761519;4831;551;265;286
4733;32848698;4832;700;343;357
4734;23769144;4833;525;216;309
4735;32915777;4834;900;450;450
4736;32835147;4835;1021;440;581
4737;32841471;4836;1034;517;517
4738;32761520;4837;1124;551;573
4739;32857381;4838;1456;583;873
4740;32962530;4839;605;249;356
4741;32828447;4840;633;279;354
4742;32913432;4841;1284;565;719
4743;45858344;4842;643;322;321
4744;47058616;4843;591;261;330
4745;11073175;4844;789;379;410
4746;43832831;4845;671;289;382
4747;32817536;4846;1043;501;542
4748;70216473;4847;1246;549;697
4749;32817477;4848;1458;700;758
4750;32832958;4849;615;283;332
4751;47909915;4850;1331;520;811
4752;60070225;4851;1150;495;655
4753;45496251;4852;698;315;383
4754;47857043;4853;1047;461;586
4755;72917516;4854;716;344;372
4756;32989138;4855;994;448;546
4757;41477380;4856;628;302;326
4758;47389120;4857;1070;525;545
4759;32837227;4858;1157;579;578
4760;41841390;4859;955;449;506
4761;76569508;4860;927;464;463
4762;32849597;4861;1473;619;854
4763;74693311;4862;886;390;496
4764;32974415;4863;1296;623;673
4765;33263160;4864;944;435;509
4766;73057517;4865;1278;652;626
4767;71437859;4866;1081;498;583
4768;75666102;4867;926;389;537
4769;76748105;4868;659;277;382
4770;32906301;4869;1069;482;587
4771;3867331;4870;1116;480;636
4772;75156685;4871;806;379;427
4773;32854603;4872;564;237;327
4774;43502487;4873;754;362;392
4775;48182568;4874;1262;619;643
4776;74420336;4875;1320;608;712
4777;32970091;4876;737;362;375
4778;43070718;4877;1387;680;707
4779;62036559;4878;1441;577;864
4780;32790436;4879;968;484;484
4781;75201953;4880;1210;509;701
4782;32944208;4881;689;331;358
4783;40611068;4882;948;399;549
4784;82863276;4883;1330;652;678
4785;33264541;4884;1351;554;797
4786;32963023;4885;700;301;399
4787;32831716;4886;837;386;451
4788;43824847;4887;1017;509;508
4789;40330959;4888;1122;472;650
4790;46671455;4889;888;418;470
4791;32896646;4890;742;334;408
4792;32968106;4891;1048;493;555
4793;32834915;4892;1397;643;754
4794;32541637;4893;979;441;538
4795;32734444;4894;882;406;476
4796;32864330;4895;842;379;463
4797;9958448;4896;842;413;429
4798;32961451;4897;1066;480;586
4799;32911056;4898;1117;514;603
4800;32907642;4899;1168;479;689
4801;32972489;4900;592;255;337
4802;47555909;4901;872;393;479
4803;32765043;4902;663;319;344
4804;32770260;4903;577;237;340
4805;40047840;4904;1296;597;699
4806;32962591;4905;1193;537;656
4807;45111438;4906;1093;492;601
4808;44606943;4907;1068;460;608
4809;32988218;4908;978;470;508
4810;32802555;4909;837;352;485
4811;47509930;4910;1404;604;800
4812;45216663;4911;1279;525;754
4813;72917432;4912;893;358;535
4814;40984692;4913;978;441;537
4815;41302846;4914;672;276;396
4816;72798629;4915;1160;569;591
4817;73299844;4916;1235;519;716
4818;71487074;4917;628;296;332
4819;32941684;4918;1237;631;606
4820;74546177;4919;1092;492;600
4821;77391540;4920;508;234;274
4822;32973870;4921;1316;645;671
4823;32868057;4922;808;380;428
4824;42997581;4923;806;387;419
4825;34937972;4924;1005;503;502
4826;13293678;4925;1001;401;600
4827;13367434;4926;951;381;570
4828;74517648;4927;1291;594;697
4829;32824264;4928;1210;533;677
4830;41652620;4929;911;365;546
4831;7247418;4930;1076;463;613
4832;32834575;4931;1376;633;743
4833;25805307;4932;1208;496;712
4834;32970454;4933;925;454;471
4835;40160026;4934;619;260;359
4836;32852746;4935;511;246;265
4837;47124359;4936;937;394;543
4838;43426808;4937;1162;547;615
4839;42562144;4938;1049;473;576
4840;44682771;4939;937;469;468
4841;32972924;4940;798;399;399
4842;25830339;4941;610;263;347
4843;32860767;4942;615;277;338
4844;80195248;4943;1083;510;573
4845;80260016;4944;549;231;318
4846;40193936;4945;835;351;484
4847;41222182;4946;1008;424;584
4848;32904513;4947;1035;518;517
4849;19322052;4948;982;403;579
4850;42611155;4949;560;275;285
4851;32932980;4950;727;357;370
4852;33260230;4951;1479;740;739
4853;47823885;4952;547;252;295
4854;44321542;4953;720;353;367
4855;32813116;4954;1067;449;618
4856;46052747;4955;746;291;455
4857;47204599;4956;1429;715;714
4858;32852181;4957;842;346;496
4859;71311952;4958;993;457;536
4860;40955473;4959;1236;631;605
4861;32905251;4960;1283;629;654
4862;41106817;4961;754;370;384
4863;32951980;4962;903;452;451
4864;42307508;4963;709;291;418
4865;44236708;4964;1403;702;701
4866;32818014;4965;1229;529;700
4867;44045981;4966;962;395;567
4868;32922229;4967;711;306;405
4869;45794303;4968;914;412;502
4870;44876835;4969;979;451;528
4871;26220928;4970;1160;499;661
4872;54451469;4971;727;306;421
4873;88053831;4972;591;237;354
4874;32820892;4973;1407;606;801
4875;9281045;4974;671;302;369
4876;32788049;4975;681;287;394
4877;32814473;4976;1016;417;599
4878;40067044;4977;777;319;458
4879;46737447;4978;715;294;421
4880;32852161;4979;1114;502;612
4881;70012300;4980;764;344;420
4882;32970635;4981;1419;554;865
4883;32848558;4982;1135;579;556
4884;44894444;4983;575;265;310
4885;42752599;4984;842;379;463
4886;19216384;4985;1299;663;636
4887;32850828;4986;1370;631;739
4888;43163850;4987;955;478;477
4889;71345900;4988;1289;606;683
4890;43123334;4989;1309;629;680
4891;40316393;4990;1404;576;828
4892;24003277;4991;1213;534;679
4893;66744895;4992;1431;587;844
4894;68364438;4993;1152;461;691
4895;43533188;4994;635;312;323
4896;81282469;4995;647;259;388
4897;99253619;4996;1088;457;631
4898;93882432;4997;1112;568;544
4899;21329857;4998;1201;565;636
4900;53920783;4999;831;358;473
4901;4426814;5000;1317;606;711
4902;76728916;5001;673;337;336
4903;22994026;5002;1007;494;513
4904;32885725;5003;1377;648;729
4905;47962324;5004;1384;582;802
4906;41082078;5005;1022;409;613
4907;32907508;5006;1054;464;590
4908;9544948;5007;837;386;451
4909;32930850;5008;1032;516;516
4910;85854240;5009;1328;518;810
4911;32933120;5010;1030;423;607
4912;32938026;5011;954;458;496
4913;32805565;5012;968;397;571
4914;42160559;5013;1068;449;619
4915;42777360;5014;922;379;543
4916;32830123;5015;594;268;326
4917;43053999;5016;508;214;294
4918;32983937;5017;955;411;544
4919;32953851;5018;629;265;364
4920;43074354;5019;725;312;413
4921;44606861;5020;986;395;591
4922;40235023;5021;1053;485;568
4923;42608158;5022;1226;515;711
4924;32860652;5023;1100;429;671
4925;47194951;5024;992;427;565
4926;3661618;5025;1252;539;713
4927;42979280;5026;926;408;518
4928;45155563;5027;1113;435;678
4929;32974163;5028;1340;670;670
4930;32641357;5029;764;360;404
4931;42777369;5030;763;351;412
4932;32775453;5031;787;378;409
4933;10566891;5032;1166;560;606
4934;71468352;5033;675;277;398
4935;32944484;5034;681;321;360
4936;32943219;5035;1438;705;733
4937;34360382;5036;743;320;423
4938;32260767;5037;1342;564;778
4939;41553454;5038;703;338;365
4940;40278180;5039;1397;629;768
4941;32848195;5040;1123;450;673
4942;32885894;5041;1354;610;744
4943;47717685;5042;902;370;532
4944;32938714;5043;1309;629;680
4945;32988513;5044;997;399;598
4946;32942198;5045;1043;532;511
4947;47138770;5046;749;315;434
4948;32984812;5047;1011;405;606
4949;44812048;5048;2393;1053;1340
4950;15613943;5049;1857;929;928
4951;40594778;5050;1515;667;848
4952;19078483;5051;1953;860;1093
4953;44126572;5052;2532;1089;1443
4954;42026952;5053;1180;579;601
4955;43177029;5054;1360;626;734
4956;32764120;5055;704;282;422
4957;32944362;5056;722;289;433
4958;32773486;5057;759;319;440
4959;43783738;5058;1143;538;605
4960;32929419;5059;1218;500;718
4961;19090882;5060;1076;495;581
4962;40385459;5061;1500;735;765
4963;80393576;5062;1183;509;674
4964;43324946;5063;1044;470;574
4965;46636566;5064;1017;478;539
4966;32982630;5065;842;379;463
4967;19040227;5066;992;457;535
4968;40277722;5067;716;330;386
4969;48405647;5068;997;409;588
4970;32130457;5069;1351;581;770
4971;45076183;5070;690;318;372
4972;9475598;5071;961;385;576
4973;70608252;5072;573;270;303
4974;73245286;5073;1107;443;664
4975;48170705;5074;965;483;482
4976;61338239;5075;1118;459;659
4977;75282019;5076;1061;425;636
4978;70608246;5077;656;276;380
4979;61338238;5078;626;301;325
4980;70609673;5079;672;296;376
4981;9548627;5080;1191;477;714
4982;70912188;5081;1359;680;679
4983;70775123;5082;861;397;464
4984;42671724;5083;1214;583;631
4985;61338264;5084;551;254;297
4986;41268410;5085;1015;508;507
4987;32798004;5086;1261;518;743
4988;32793896;5087;1391;585;806
4989;32854007;5088;1207;507;700
4990;32939171;5089;608;311;297
4991;32834136;5090;1005;443;562
4992;32917182;5091;1261;505;756
4993;32766118;5092;1046;471;575
4994;32825403;5093;832;416;416
4995;32918027;5094;1415;581;834
4996;32973110;5095;1296;519;777
4997;32856228;5096;1480;622;858
4998;32772757;5097;1020;470;550
4999;45923160;5098;1206;543;663
5000;80396015;5099;1372;590;782
5001;44952896;5100;1143;526;617
5002;32943395;5101;561;236;325
5003;32138993;5102;1168;479;689
5004;32965908;5103;961;471;490
5005;4002580;5104;1355;610;745
5006;43133569;5105;1112;445;667
5007;32813576;5106;1060;446;614
5008;70228352;5107;924;370;554
5009;44089601;5108;1003;442;561
5010;32847437;5109;764;329;435
5011;32804097;5110;711;278;433
5012;32868328;5111;1052;505;547
5013;32803913;5112;620;286;334
5014;32803692;5113;1296;519;777
5015;42690877;5114;1402;716;686
5016;32857240;5115;566;267;299
5017;32847434;5116;1060;520;540
5018;32961239;5117;1426;642;784
5019;45948128;5118;1062;521;541
5020;41122717;5119;1291;633;658
5021;43813507;5120;973;468;505
5022;41664039;5121;1113;457;656
5023;5407094;5122;929;400;529
5024;47312499;5123;1057;508;549
5025;32975943;5124;759;380;379
5026;73663564;5125;949;447;502
5027;42026664;5126;676;318;358
5028;33324900;5127;871;366;505
5029;45622304;5128;662;292;370
5030;32956584;5129;715;279;436
5031;32819056;5130;1321;555;766
5032;70015365;5131;1015;488;527
5033;32970855;5132;993;437;556
5034;32858325;5133;1400;644;756
5035;32988225;5134;550;220;330
5036;47138695;5135;1189;607;582
5037;32765287;5136;1072;526;546
5038;32911277;5137;897;377;520
5039;45875413;5138;993;467;526
5040;70018407;5139;1340;670;670
5041;32958355;5140;718;309;409
5042;47558693;5141;712;307;405
5043;32836152;5142;1430;615;815
5044;32915181;5143;1387;583;804
5045;42871067;5144;1026;442;584
5046;44022107;5145;694;320;374
5047;42764563;5146;1112;434;678
5048;32986811;5147;1392;683;709
5049;47622521;5148;659;330;329
5050;69326392;5149;977;411;566
5051;33758992;5150;1500;765;735
5052;18158469;5151;701;309;392
5053;44565591;5152;1047;451;596
5054;45371726;5153;718;316;402
5055;42478960;5154;1199;492;707
5056;43425646;5155;1001;421;580
5057;46989637;5156;686;282;404
5058;32909787;5157;1333;600;733
5059;32138606;5158;893;402;491
5060;41128505;5159;1288;529;759
5061;48103134;5160;824;396;428
5062;76129512;5161;1040;500;540
5063;40356757;5162;980;402;578
5064;48458129;5163;1128;463;665
5065;48319940;5164;1038;509;529
5066;43568078;5165;1286;528;758
5067;41588421;5166;1480;696;784
5068;32868749;5167;681;273;408
5069;32909803;5168;1034;424;610
5070;32738793;5169;736;288;448
5071;2833368;5170;792;341;451
5072;66089495;5171;1307;615;692
5073;32952844;5172;587;259;328
5074;32850280;5173;841;404;437
5075;33279335;5174;900;387;513
5076;32849752;5175;790;324;466
5077;41459396;5176;1328;585;743
5078;32733265;5177;1243;622;621
5079;32942740;5178;1497;614;883
5080;32919141;5179;1122;505;617
5081;29071984;5180;1001;451;550
5082;80307873;5181;1201;601;600
5083;32978776;5182;501;241;260
5084;32249994;5183;1228;590;638
5085;45059226;5184;1203;518;685
5086;48659621;5185;562;265;297
5087;32781989;5186;1153;577;576
5088;43148655;5187;1075;441;634
5089;48426817;5188;1413;721;692
5090;32939241;5189;1280;628;652
5091;46657388;5190;630;297;333
5092;46644114;5191;1440;692;748
5093;32978877;5192;1249;550;699
5094;46542620;5193;752;346;406
5095;47322137;5194;825;355;470
5096;40613886;5195;1234;531;703
5097;47652870;5196;513;231;282
5098;32284229;5197;1252;526;726
5099;32921520;5198;1278;524;754
5100;43110257;5199;1049;431;618
5101;8551083;5200;1050;462;588
5102;32913240;5201;1279;538;741
5103;44137847;5202;873;385;488
5104;32963911;5203;1027;473;554
5105;42739130;5204;1118;571;547
5106;46138469;5205;524;242;282
5107;9629451;5206;1491;686;805
5108;76862692;5207;1084;510;574
5109;44545125;5208;1298;662;636
5110;43287024;5209;557;273;284
5111;32892136;5210;772;363;409
5112;76738724;5211;1130;554;576
5113;40025252;5212;931;457;474
5114;40932846;5213;984;483;501
5115;48722650;5214;1074;419;655
5116;32921800;5215;934;383;551
5117;44616705;5216;525;242;283
5118;70015345;5217;1474;723;751
5119;33264208;5218;1131;555;576
5120;47713952;5219;954;439;515
5121;73987681;5220;748;337;411
5122;32963918;5221;705;332;373
5123;87323167;5222;1389;626;763
5124;60761831;5223;1134;567;567
5125;32918334;5224;520;250;270
5126;32984698;5225;928;409;519
5127;44955387;5226;566;233;333
5128;47241793;5227;1068;545;523
5129;40369370;5228;629;271;358
5130;32931808;5229;1360;667;693
5131;32960246;5230;1343;659;684
5132;76862693;5231;545;229;316
5133;48031287;5232;778;382;396
5134;47827443;5233;1370;631;739
5135;32915266;5234;806;379;427
5136;32852617;5235;779;398;381
5137;32927459;5236;1359;626;733
5138;71802390;5237;664;313;351
5139;15978557;5238;1372;645;727
5140;48686308;5239;866;416;450
5141;11451911;5240;759;350;409
5142;76160633;5241;527;222;305
5143;57095140;5242;1267;520;747
5144;32836901;5243;1427;557;870
5145;8830996;5244;619;310;309
5146;46998166;5245;549;220;329
5147;47831144;5246;1030;474;556
5148;70129148;5247;1469;647;822
5149;32847045;5248;1137;546;591
5150;6057584;5249;1153;496;657
5151;32926041;5250;840;395;445
5152;32919376;5251;1173;481;692
5153;26598360;5252;654;334;320
5154;32787391;5253;604;278;326
5155;97261007;5254;1019;469;550
5156;32829072;5255;845;338;507
5157;32736488;5256;662;338;324
5158;47811580;5257;1393;613;780
5159;42979009;5258;702;316;386
5160;45716374;5259;1264;544;720
5161;32772878;5260;844;355;489
5162;10590258;5261;586;264;322
5163;42219837;5262;973;487;486
5164;42490377;5263;914;430;484
5165;32914374;5264;837;377;460
5166;20900645;5265;1340;577;763
5167;45665862;5266;1001;441;560
5168;202945;5267;1212;606;606
5169;47190395;5268;687;282;405
5170;32979107;5269;736;368;368
5171;40998428;5270;1347;539;808
5172;19233934;5271;689;331;358
5173;40003276;5272;980;471;509
5174;43620906;5273;1453;742;711
5175;32910695;5274;1357;570;787
5176;48136592;5275;1296;610;686
5177;32816435;5276;1465;689;776
5178;18094752;5277;573;253;320
5179;32966987;5278;1107;499;608
5180;40329085;5279;1348;580;768
5181;32921283;5280;823;404;419
5182;18135247;5281;1279;512;767
5183;32791811;5282;1143;481;662
5184;32904927;5283;1282;629;653
5185;46185513;5284;662;318;344
5186;32902832;5285;941;433;508
5187;32912666;5286;1057;518;539
5188;43333768;5287;715;344;371
5189;32955032;5288;1245;548;697
5190;32992454;5289;545;257;288
5191;44252953;5290;1110;522;588
5192;19098962;5291;1366;643;723
5193;32824133;5292;591;278;313
5194;19570386;5293;1277;613;664
5195;3690975;5294;1009;394;615
5196;32950856;5295;1164;454;710
5197;46353764;5296;1259;580;679
5198;32973321;5297;1473;604;869
5199;46822842;5298;629;265;364
5200;42002836;5299;1125;529;596
5201;32961865;5300;533;251;282
5202;77205829;5301;1298;649;649
5203;33989059;5302;1257;629;628
5204;32871401;5303;950;466;484
5205;48049721;5304;1425;642;783
5206;44763338;5305;1056;412;644
5207;41234534;5306;680;300;380
5208;70055547;5307;936;431;505
5209;43436371;5308;542;255;287
5210;32226195;5309;1029;433;596
5211;72885620;5310;1476;591;885
5212;80198983;5311;555;239;316
5213;71470118;5312;1053;527;526
5214;48074667;5313;1047;514;533
5215;47538697;5314;1211;497;714
5216;76179074;5315;1064;426;638
5217;98696640;5316;813;366;447
5218;72687466;5317;1308;563;745
5219;71041944;5318;918;441;477
5220;42568275;5319;1010;415;595
5221;32945585;5320;1069;546;523
5222;32918460;5321;1475;635;840
5223;73519159;5322;954;411;543
5224;72128783;5323;1150;460;690
5225;73516903;5324;1221;538;683
5226;32989135;5325;697;321;376
5227;41103716;5326;592;285;307
5228;44561954;5327;786;378;408
5229;32960075;5328;1010;404;606
5230;45976665;5329;1490;582;908
5231;47387175;5330;988;494;494
5232;45158191;5331;584;234;350
5233;41219994;5332;1106;553;553
5234;42485223;5333;1340;590;750
5235;40053819;5334;1414;707;707
5236;32969069;5335;1438;619;819
5237;33676332;5336;1295;570;725
5238;32970937;5337;1185;534;651
5239;83147613;5338;847;407;440
5240;41825863;5339;704;352;352
5241;32992206;5340;530;255;275
5242;32852369;5341;1390;612;778
5243;32831664;5342;861;345;516
5244;32972080;5343;1032;486;546
5245;32977327;5344;1119;538;581
5246;48481426;5345;710;306;404
5247;43269919;5346;616;278;338
5248;41239255;5347;1106;498;608
5249;73897526;5348;1385;679;706
5250;32138632;5349;1300;598;702
5251;32952964;5350;1161;500;661
5252;32793577;5351;1066;470;596
5253;32904050;5352;1217;487;730
5254;41170722;5353;1355;624;731
5255;41380808;5354;870;401;469
5256;40961472;5355;1210;533;677
5257;74278942;5356;822;346;476
5258;48370603;5357;827;364;463
5259;43255460;5358;1319;634;685
5260;16128593;5359;1206;519;687
5261;10566010;5360;1474;590;884
5262;47767805;5361;1459;657;802
5263;47615754;5362;866;442;424
5264;44667635;5363;786;370;416
5265;32850696;5364;530;250;280
5266;42949598;5365;973;487;486
5267;99757882;5366;720;353;367
5268;32854408;5367;762;343;419
5269;28236442;5368;869;365;504
5270;32907165;5369;1038;468;570
5271;40274673;5370;1290;529;761
5272;32854430;5371;994;448;546
5273;3377694;5372;1033;507;526
5274;32804540;5373;618;297;321
5275;47843855;5374;1003;452;551
5276;40513888;5375;600;240;360
5277;46253233;5376;812;358;454
5278;46105453;5377;549;259;290
5279;32738619;5378;906;453;453
5280;47336347;5379;902;370;532
5281;32822884;5380;1374;660;714
5282;32803768;5381;1005;503;502
5283;32787346;5382;1456;714;742
5284;32920330;5383;983;433;550
5285;3377610;5384;555;228;327
5286;19060030;5385;1427;714;713
5287;45518870;5386;623;293;330
5288;32957020;5387;935;374;561
5289;46881378;5388;830;332;498
5290;32967238;5389;1390;640;750
5291;47154021;5390;564;266;298
5292;73030821;5391;1131;543;588
5293;44795193;5392;1378;593;785
5294;48475806;5393;1373;687;686
5295;76442956;5394;702;323;379
5296;32960873;5395;934;383;551
5297;41757433;5396;994;428;566
5298;48255569;5397;1285;617;668
5299;7940683;5398;1334;547;787
5300;32869995;5399;536;215;321
5301;45246948;5400;680;272;408
5302;32925159;5401;678;339;339
5303;40117366;5402;1382;664;718
5304;32782615;5403;768;369;399
5305;45273653;5404;1200;576;624
5306;42778683;5405;602;241;361
5307;80262607;5406;1324;596;728
5308;32791717;5407;1003;412;591
5309;40424764;5408;1168;538;630
5310;17914776;5409;1396;698;698
5311;32912103;5410;745;336;409
5312;47172451;5411;924;435;489
5313;79455912;5412;680;320;360
5314;994145;5413;1086;500;586
5315;47296018;5414;1481;741;740
5316;48149315;5415;1163;524;639
5317;45981845;5416;975;410;565
5318;32929944;5417;695;292;403
5319;45931759;5418;871;445;426
5320;41652618;5419;818;369;449
5321;48279187;5420;1127;553;574
5322;48519225;5421;811;374;437
5323;45423488;5422;565;226;339
5324;32948583;5423;1082;444;638
5325;32854534;5424;1369;534;835
5326;53492552;5425;1041;521;520
5327;42900440;5426;849;408;441
5328;32764460;5427;989;406;583
5329;71044278;5428;1379;607;772
5330;40458734;5429;748;292;456
5331;32917491;5430;1162;454;708
5332;43164394;5431;957;460;497
5333;44966324;5432;726;334;392
5334;47844859;5433;1268;584;684
5335;47278873;5434;528;270;258
5336;80337132;5435;1212;619;593
5337;47216314;5436;750;338;412
5338;32733095;5437;772;379;393
5339;32948025;5438;572;264;308
5340;32807019;5439;802;361;441
5341;32935992;5440;966;474;492
5342;32735924;5441;769;308;461
5343;43860433;5442;1310;669;641
5344;71047569;5443;685;329;356
5345;32910114;5444;782;368;414
5346;32937059;5445;1045;418;627
5347;32936629;5446;811;341;470
5348;72180041;5447;1456;597;859
5349;32936739;5448;838;352;486
5350;32934434;5449;915;385;530
5351;32935153;5450;663;266;397
5352;32964166;5451;842;337;505
5353;40821775;5452;1298;546;752
5354;42529811;5453;820;361;459
5355;32912360;5454;682;301;381
5356;32821529;5455;536;268;268
5357;32803571;5456;1038;436;602
5358;41276227;5457;1158;510;648
5359;32978971;5458;884;363;521
5360;73853627;5459;1356;624;732
5361;32965345;5460;727;364;363
5362;59097232;5461;734;367;367
5363;48736576;5462;1020;439;581
5364;45673987;5463;1412;565;847
5365;47013399;5464;1325;650;675
5366;46305351;5465;1047;482;565
5367;32867431;5466;1397;587;810
5368;46142554;5467;603;284;319
5369;44810229;5468;1447;579;868
5370;77034814;5469;1123;461;662
5371;32542572;5470;833;334;499
5372;41664045;5471;1358;652;706
5373;19677069;5472;1479;725;754
5374;76512802;5473;580;261;319
5375;32953263;5474;2678;1232;1446
5376;47902414;5475;1720;706;1014
5377;42490378;5476;1597;719;878
5378;45589042;5477;2591;1218;1373
5379;32955403;5478;2216;998;1218
5380;14968203;5479;1726;708;1018
5381;46974699;5480;2645;1085;1560
5382;46180930;5481;1839;902;937
5383;32846394;5482;2623;1312;1311
5384;47514042;5483;2256;1038;1218
5385;47595580;5484;1651;809;842
5386;86621316;5485;2372;949;1423
5387;74703682;5486;1650;759;891
5388;32885244;5487;1946;818;1128
5389;46781591;5488;1174;587;587
5390;41162560;5489;833;359;474
5391;32883681;5490;722;340;382
5392;32885075;5491;1157;498;659
5393;47586442;5492;1475;723;752
5394;32870738;5493;1286;515;771
5395;44662460;5494;1093;492;601
5396;42258009;5495;926;445;481
5397;32885174;5496;642;296;346
5398;32950125;5497;820;378;442
5399;8673520;5498;1406;675;731
5400;32883437;5499;1494;673;821
5401;47790156;5500;1398;616;782
5402;32885365;5501;1141;548;593
5403;32884455;5502;927;362;565
5404;32879599;5503;1488;670;818
5405;32907687;5504;956;383;573
5406;45053858;5505;785;369;416
5407;43611873;5506;817;368;449
5408;32950188;5507;1404;660;744
5409;32880576;5508;1367;602;765
5410;48630025;5509;689;338;351
5411;32884238;5510;805;379;426
5412;44565685;5511;929;409;520
5413;32950233;5512;1069;503;566
5414;32827721;5513;1299;572;727
5415;32734855;5514;1480;622;858
5416;32884278;5515;960;461;499
5417;60305816;5516;1263;632;631
5418;32884372;5517;902;370;532
5419;45345502;5518;799;320;479
5420;26482943;5519;558;257;301
5421;17930923;5520;1366;697;669
5422;40278185;5521;905;381;524
5423;32922781;5522;560;258;302
5424;32869541;5523;826;364;462
5425;32842468;5524;504;222;282
5426;32968341;5525;1126;496;630
5427;26958826;5526;1103;486;617
5428;32278401;5527;854;393;461
5429;32844186;5528;1481;667;814
5430;46997262;5529;977;430;547
5431;41188877;5530;1269;521;748
5432;32735127;5531;710;306;404
5433;44560892;5532;1379;676;703
5434;45313615;5533;938;451;487
5435;40652585;5534;1155;497;658
5436;32107133;5535;1102;430;672
5437;32941451;5536;700;294;406
5438;48530569;5537;1184;486;698
5439;32969006;5538;1049;452;597
5440;42159516;5539;727;335;392
5441;46382839;5540;861;362;499
5442;44201759;5541;1060;456;604
5443;40665497;5542;1126;552;574
5444;43560494;5543;853;376;477
5445;80248755;5544;1219;500;719
5446;40692502;5545;824;322;502
5447;45391184;5546;553;238;315
5448;32979052;5547;645;265;380
5449;32820129;5548;817;327;490
5450;72937211;5549;1234;543;691
5451;32977385;5550;970;427;543
5452;45514867;5551;1067;427;640
5453;40186124;5552;665;313;352
5454;45612868;5553;522;209;313
5455;41561416;5554;814;326;488
5456;43255213;5555;1151;461;690
5457;17635910;5556;1175;470;705
5458;40918519;5557;547;258;289
5459;32986399;5558;575;259;316
5460;32981320;5559;900;414;486
5461;17892717;5560;991;437;554
5462;32856092;5561;1325;663;662
5463;64830037;5562;809;324;485
5464;32974111;5563;1428;672;756
5465;32265107;5564;1457;714;743
5466;42491766;5565;1471;707;764
5467;32904726;5566;515;263;252
5468;44964579;5567;594;280;314
5469;32911341;5568;978;421;557
5470;17883299;5569;805;395;410
5471;80194437;5570;533;272;261
5472;32928492;5571;573;241;332
5473;38041871;5572;1072;547;525
5474;32971448;5573;1136;444;692
5475;32820696;5574;660;330;330
5476;32812262;5575;1330;599;731
5477;46884263;5576;586;282;304
5478;32966691;5577;1042;417;625
5479;32963792;5578;884;416;468
5480;32764865;5579;634;317;317
5481;32948912;5580;1285;540;745
5482;32542842;5581;1013;426;587
5483;61746678;5582;1327;637;690
5484;32968183;5583;754;362;392
5485;32912683;5584;614;271;343
5486;32541973;5585;1240;534;706
5487;32925072;5586;1452;683;769
5488;32945953;5587;699;301;398
5489;43674180;5588;1424;584;840
5490;32989286;5589;619;273;346
5491;47194804;5590;656;276;380
5492;44332352;5591;644;310;334
5493;19060843;5592;1104;453;651
5494;77388041;5593;666;280;386
5495;32963706;5594;883;416;467
5496;32855705;5595;666;280;386
5497;46676627;5596;1500;585;915
5498;32855746;5597;628;289;339
5499;32845257;5598;643;303;340
5500;76552729;5599;1057;476;581
5501;32973772;5600;748;315;433
5502;42662020;5601;536;220;316
5503;71046224;5602;557;240;317
5504;32945383;5603;934;421;513
5505;32835038;5604;714;322;392
5506;45578091;5605;1453;654;799
5507;9452257;5606;841;387;454
5508;70216502;5607;1103;464;639
5509;42250135;5608;979;402;577
5510;45006995;5609;522;225;297
5511;42867718;5610;1237;557;680
5512;32964956;5611;742;327;415
5513;76237006;5612;586;241;345
5514;32949164;5613;945;416;529
5515;41263199;5614;909;391;518
5516;45328813;5615;1440;605;835
5517;56298005;5616;914;357;557
5518;44268734;5617;691;311;380
5519;32851769;5618;1373;660;713
5520;32640047;5619;1282;552;730
5521;32840457;5620;1134;556;578
5522;32910501;5621;1483;757;726
5523;80309774;5622;1139;559;580
5524;45189589;5623;1249;513;736
5525;40070704;5624;1265;646;619
5526;32926534;5625;1453;654;799
5527;80927;5626;1418;582;836
5528;32834536;5627;718;288;430
5529;45774055;5628;1143;538;605
5530;32964630;5629;1182;556;626
5531;32772509;5630;1394;670;724
5532;32908575;5631;947;436;511
5533;3376201;5632;547;258;289
5534;99119186;5633;1158;579;579
5535;74339581;5634;516;217;299
5536;49900440;5635;689;304;385
5537;32861770;5636;1169;562;607
5538;33260208;5637;629;258;371
5539;32943144;5638;705;346;359
5540;32828198;5639;1182;473;709
5541;32910748;5640;544;278;266
5542;32963631;5641;646;252;394
5543;45620327;5642;1070;471;599
5544;32848613;5643;618;266;352
5545;32991511;5644;1353;623;730
5546;73384344;5645;1236;495;741
5547;80204700;5646;544;251;293
5548;74022388;5647;647;318;329
5549;27872313;5648;1445;636;809
5550;80332068;5649;938;366;572
5551;47642737;5650;677;285;392
5552;43718093;5651;565;277;288
5553;43036645;5652;1449;696;753
5554;327590;5653;1302;638;664
5555;48340066;5654;1495;658;837
5556;80192324;5655;698;343;355
5557;72943251;5656;637;319;318
5558;45136613;5657;988;465;523
5559;6196307;5658;921;424;497
5560;32733885;5659;537;258;279
5561;42756181;5660;1467;749;718
5562;43544936;5661;682;301;381
5563;33262919;5662;1079;540;539
5564;33265434;5663;1470;647;823
5565;32859768;5664;520;224;296
5566;32954617;5665;588;242;346
5567;33259880;5666;1001;471;530
5568;40685816;5667;1317;567;750
5569;46219044;5668;892;393;499
5570;46380897;5669;763;367;396
5571;80200937;5670;1131;476;655
5572;19994757;5671;989;485;504
5573;19600968;5672;1063;532;531
5574;41109910;5673;1387;597;790
5575;44773847;5674;605;261;344
5576;70012220;5675;713;293;420
5577;33264560;5676;1000;490;510
5578;32982764;5677;1385;693;692
5579;53758346;5678;1040;437;603
5580;328342;5679;1218;536;682
5581;44841884;5680;771;394;377
5582;80200573;5681;1404;660;744
5583;40740372;5682;1431;730;701
5584;77573857;5683;1119;482;637
5585;71327691;5684;640;314;326
5586;70012294;5685;905;381;524
5587;47353377;5686;600;246;354
5588;32957381;5687;961;452;509
5589;80353801;5688;623;300;323
5590;32961902;5689;625;263;362
5591;46884268;5690;903;443;460
5592;47268007;5691;1071;493;578
5593;45246929;5692;1194;514;680
5594;70012320;5693;881;388;493
5595;32911374;5694;1016;458;558
5596;72880593;5695;1321;608;713
5597;32987689;5696;1179;519;660
5598;32828430;5697;828;406;422
5599;875818;5698;724;348;376
5600;32732812;5699;706;325;381
5601;32941280;5700;1475;723;752
5602;9787829;5701;551;282;269
5603;32916686;5702;1026;493;533
5604;32853550;5703;1034;517;517
5605;32927434;5704;551;232;319
5606;43354395;5705;1379;566;813
5607;44045978;5706;517;243;274
5608;32820851;5707;1472;707;765
5609;45658995;5708;1152;484;668
5610;32967241;5709;670;289;381
5611;18835893;5710;971;467;504
5612;45392475;5711;599;234;365
5613;86033747;5712;1149;552;597
5614;47551240;5713;1263;619;644
5615;80596445;5714;1224;564;660
5616;32911310;5715;887;417;470
5617;32795654;5716;1201;601;600
5618;32855048;5717;1264;569;695
5619;32807873;5718;502;236;266
5620;32739412;5719;839;403;436
5621;43626746;5720;933;392;541
5622;32851775;5721;1293;647;646
5623;33250390;5722;599;276;323
5624;47608599;5723;1313;631;682
5625;76618210;5724;822;403;419
5626;32784635;5725;1422;598;824
5627;32937558;5726;969;378;591
5628;32865526;5727;1038;468;570
5629;32984713;5728;1028;401;627
5630;41954860;5729;1253;589;664
5631;17562784;5730;660;297;363
5632;47318535;5731;760;342;418
5633;32937727;5732;535;241;294
5634;32984100;5733;1457;627;830
5635;42428042;5734;570;257;313
5636;44792193;5735;1390;584;806
5637;41700385;5736;1011;486;525
5638;43577318;5737;993;418;575
5639;32975990;5738;816;392;424
5640;32737639;5739;1275;510;765
5641;32789933;5740;717;337;380
5642;31179181;5741;624;244;380
5643;47634048;5742;1150;483;667
5644;8644583;5743;1479;666;813
5645;18103744;5744;1250;588;662
5646;70118869;5745;1399;574;825
5647;46437523;5746;997;389;608
5648;26732474;5747;1290;542;748
5649;32737755;5748;935;421;514
5650;18116509;5749;1315;632;683
5651;32933421;5750;741;289;452
5652;32844920;5751;526;269;257
5653;32740868;5752;1211;473;738
5654;47022915;5753;585;281;304
5655;76854681;5754;1388;583;805
5656;43993602;5755;579;267;312
5657;32821253;5756;1358;612;746
5658;11523113;5757;1336;642;694
5659;40970947;5758;781;344;437
5660;44383760;5759;850;434;416
5661;32922944;5760;862;397;465
5662;80180177;5761;1334;534;800
5663;48453295;5762;1242;497;745
5664;46931611;5763;1089;480;609
5665;71806984;5764;1242;510;732
5666;42482168;5765;536;236;300
5667;64901873;5766;914;457;457
5668;17113777;5767;721;332;389
5669;85364272;5768;1327;584;743
5670;91430433;5769;1439;634;805
5671;32865259;5770;1251;538;713
5672;17889654;5771;786;393;393
5673;44884056;5772;600;258;342
5674;74420488;5773;1143;481;662
5675;32925232;5774;1295;635;660
5676;61559554;5775;1267;520;747
5677;42231366;5776;766;383;383
5678;32542354;5777;873;411;462
5679;43341740;5778;928;372;556
5680;41388056;5779;1199;516;683
5681;32840253;5780;942;471;471
5682;10440058;5781;863;406;457
5683;32833098;5782;1413;650;763
5684;32804573;5783;631;247;384
5685;32765469;5784;1076;420;656
5686;49276286;5785;516;217;299
5687;70169841;5786;532;251;281
5688;32785886;5787;966;426;540
5689;46818492;5788;807;412;395
5690;41771935;5789;1295;583;712
5691;32910300;5790;560;230;330
5692;32957494;5791;1451;697;754
5693;80336989;5792;519;224;295
5694;45955919;5793;803;362;441
5695;48263330;5794;1252;626;626
5696;2767372;5795;1462;615;847
5697;41088636;5796;524;236;288
5698;32866677;5797;1479;607;872
5699;41161354;5798;1164;536;628
5700;71345935;5799;1087;479;608
5701;32833678;5800;507;224;283
5702;41180374;5801;753;354;399
5703;80330102;5802;536;258;278
5704;32833217;5803;648;331;317
5705;10779378;5804;1149;586;563
5706;43171395;5805;511;220;291
5707;47581023;5806;644;252;392
5708;42358104;5807;1281;590;691
5709;32975433;5808;1413;566;847
5710;80587485;5809;835;368;467
5711;67617664;5810;1000;440;560
5712;40589542;5811;853;436;417
5713;22267358;5812;690;283;407
5714;43747717;5813;723;326;397
5715;32781556;5814;1431;659;772
5716;45814397;5815;1416;595;821
5717;40724529;5816;516;258;258
5718;44606890;5817;969;485;484
5719;7600343;5818;536;226;310
5720;17984095;5819;917;413;504
5721;3465087;5820;523;225;298
5722;73768374;5821;1410;635;775
5723;80574470;5822;594;286;308
5724;32733970;5823;813;374;439
5725;32826112;5824;769;308;461
5726;40631742;5825;848;365;483
5727;47763850;5826;1241;609;632
5728;17857712;5827;684;322;362
5729;46057794;5828;1033;465;568
5730;70525070;5829;1500;675;825
5731;32911988;5830;1326;663;663
5732;70180779;5831;559;230;329
5733;41438680;5832;996;429;567
5734;48632877;5833;1225;564;661
5735;33265618;5834;694;313;381
5736;46792560;5835;897;404;493
5737;71422789;5836;1245;586;659
5738;44774835;5837;583;286;297
5739;70998646;5838;913;366;547
5740;41664374;5839;1062;510;552
5741;46022028;5840;684;322;362
5742;32927747;5841;549;231;318
5743;80379260;5842;542;250;292
5744;48074538;5843;710;284;426
5745;3507971;5844;614;258;356
5746;32888706;5845;518;259;259
5747;32814111;5846;933;439;494
5748;32845521;5847;1494;733;761
5749;71054329;5848;1114;446;668
5750;46319036;5849;797;351;446
5751;16033006;5850;952;457;495
5752;80194873;5851;1027;452;575
5753;30815753;5852;850;366;484
5754;32929173;5853;752;339;413
5755;32846085;5854;1028;484;544
5756;45394509;5855;800;352;448
5757;46807901;5856;1028;422;606
5758;52646272;5857;811;317;494
5759;45345484;5858;756;341;415
5760;32859984;5859;1391;613;778
5761;45017592;5860;517;218;299
5762;32881401;5861;1444;708;736
5763;45214315;5862;1428;600;828
5764;93290412;5863;908;454;454
5765;91240405;5864;857;360;497
5766;10426261;5865;978;401;577
5767;80220285;5866;1296;532;764
5768;40681513;5867;542;244;298
5769;32798883;5868;1499;615;884
5770;33262708;5869;583;269;314
5771;32931701;5870;1453;727;726
5772;32815920;5871;929;456;473
5773;42662025;5872;1047;430;617
5774;42651958;5873;1331;626;705
5775;41286827;5874;1032;434;598
5776;32801850;5875;844;363;481
5777;32869271;5876;870;435;435
5778;48666126;5877;1297;558;739
5779;46779260;5878;1155;486;669
5780;42777351;5879;1059;477;582
5781;32806725;5880;1170;562;608
5782;43328625;5881;667;341;326
5783;76626200;5882;1287;567;720
5784;32968713;5883;631;266;365
5785;32929167;5884;690;332;358
5786;44425594;5885;1206;483;723
5787;32944978;5886;929;391;538
5788;70001508;5887;829;407;422
5789;32935009;5888;987;474;513
5790;47648716;5889;1478;680;798
5791;71401706;5890;1109;466;643
5792;32983741;5891;1472;678;794
5793;71444550;5892;1198;504;694
5794;40247619;5893;1451;581;870
5795;41960589;5894;891;348;543
5796;32971539;5895;610;287;323
5797;32847300;5896;1389;667;722
5798;83083399;5897;677;339;338
5799;80985182;5898;525;210;315
5800;47558138;5899;872;375;497
5801;31911132;5900;737;295;442
5802;87462857;5901;710;299;411
5803;45835428;5902;1338;643;695
5804;32854026;5903;572;235;337
5805;46414632;5904;951;447;504
5806;32779292;5905;911;374;537
5807;45518244;5906;685;302;383
5808;32805514;5907;990;436;554
5809;47634059;5908;784;322;462
5810;43051972;5909;2632;1264;1368
5811;32924742;5910;2867;1291;1576
5812;47589050;5911;2900;1160;1740
5813;32733884;5912;2665;1306;1359
5814;32836834;5913;2830;1161;1669
5815;32761959;5914;2570;1131;1439
5816;47800324;5915;2640;1109;1531
5817;76413534;5916;2199;990;1209
5818;32975733;5917;2010;885;1125
5819;85510834;5918;2165;931;1234
5820;32973657;5919;1770;903;867
5821;32791144;5920;1940;970;970
5822;32805824;5921;2556;1227;1329
5823;16560455;5922;1570;691;879
5824;32916889;5923;1200;552;648
5825;32837355;5924;1035;456;579
5826;32860985;5925;843;380;463
5827;46253262;5926;1009;505;504
5828;32862750;5927;1046;503;543
5829;76400418;5928;684;336;348
5830;32980351;5929;674;311;363
5831;32764920;5930;1245;498;747
5832;76916520;5931;1160;546;614
5833;32883909;5932;588;242;346
5834;72533556;5933;710;284;426
5835;42018115;5934;673;276;397
5836;32877090;5935;549;275;274
5837;46433579;5936;1689;744;945
5838;77488362;5937;1595;782;813
5839;47399997;5938;2500;1175;1325
5840;18970694;5939;2065;868;1197
5841;72025454;5940;2180;872;1308
5842;17851450;5941;2169;1042;1127
5843;46185734;5942;2524;1061;1463
5844;16627681;5943;2668;1201;1467
5845;19331695;5944;1561;781;780
5846;32827609;5945;1601;753;848
5847;45126372;5946;2550;1275;1275
5848;41520440;5947;799;344;455
5849;41704845;5948;1170;480;690
5850;32542531;5949;503;232;271
5851;32853907;5950;1037;488;549
5852;32989143;5951;645;317;328
5853;74780582;5952;643;296;347
5854;32799833;5953;882;424;458
5855;32961622;5954;519;213;306
5856;19247429;5955;1292;530;762
5857;19247904;5956;1214;547;667
5858;16422539;5957;1198;611;587
5859;32919047;5958;1367;684;683
5860;19247819;5959;1423;570;853
5861;47762424;5960;2094;985;1109
5862;41807690;5961;2543;1094;1449
5863;17438399;5962;2552;1225;1327
5864;45292807;5963;2004;802;1202
5865;13738709;5964;2032;915;1117
5866;32962980;5965;2559;1126;1433
5867;32739680;5966;2046;1003;1043
5868;43407665;5967;2089;857;1232
5869;32980162;5968;2687;1129;1558
5870;45809226;5969;2936;1498;1438
5871;32798938;5970;2789;1256;1533
5872;32977405;5971;1208;617;591
5873;32972359;5972;1364;560;804
5874;47077054;5973;1183;592;591
5875;15378863;5974;713;336;377
5876;32807535;5975;1400;630;770
5877;42219831;5976;1046;461;585
5878;47592426;5977;756;310;446
5879;32802213;5978;1120;560;560
5880;70106699;5979;818;369;449
5881;33326501;5980;799;312;487
5882;12484990;5981;1493;732;761
5883;38808628;5982;519;250;269
5884;18014833;5983;1151;495;656
5885;32980660;5984;2764;1382;1382
5886;70111386;5985;1506;769;737
5887;46516919;5986;944;454;490
5888;80261522;5987;1073;462;611
5889;53269086;5988;550;220;330
5890;45181811;5989;1449;609;840
5891;42075595;5990;1029;443;586
5892;40437498;5991;974;449;525
5893;70088293;5992;873;402;471
5894;76402688;5993;972;428;544
5895;32825210;5994;945;416;529
5896;32769150;5995;559;241;318
5897;32824704;5996;1018;398;620
5898;32775254;5997;1016;498;518
5899;32852760;5998;873;437;436
5900;85302990;5999;2979;1490;1489
5901;19785843;6000;2663;1332;1331
5902;40639683;6001;2352;1035;1317
5903;71326147;6002;2363;1087;1276
5904;32986567;6003;1954;899;1055
5905;3466458;6004;2095;1048;1047
5906;70554770;6005;2620;1284;1336
5907;32813252;6006;2421;1138;1283
5908;51963946;6007;2689;1130;1559
5909;32817364;6008;2585;1190;1395
5910;32928755;6009;2051;882;1169
5911;80276583;6010;2393;1125;1268
5912;40918965;6011;2824;1102;1722
5913;44789140;6012;2797;1147;1650
5914;81997883;6013;2450;1078;1372
5915;32968676;6014;1576;788;788
5916;75747047;6015;2295;1125;1170
5917;40077065;6016;1640;804;836
5918;32981532;6017;2534;1141;1393
5919;46051621;6018;592;249;343
5920;47175185;6019;507;254;253
5921;32989457;6020;1342;658;684
5922;3899108;6021;1151;564;587
5923;32843170;6022;1278;550;728
5924;32138843;6023;1200;480;720
5925;46895572;6024;708;298;410
5926;43119549;6025;1498;749;749
5927;32980904;6026;882;353;529
5928;74877814;6027;1327;664;663
5929;32987212;6028;1016;437;579
5930;80387409;6029;557;279;278
5931;47965503;6030;1312;643;669
5932;32926289;6031;1585;682;903
5933;56276537;6032;866;364;502
5934;73328266;6033;924;370;554
5935;32931309;6034;565;221;344
5936;32822067;6035;1338;669;669
5937;72160522;6036;1323;596;727
5938;32941659;6037;1457;598;859
5939;40002576;6038;1278;601;677
5940;32922884;6039;1454;597;857
5941;40503562;6040;558;263;295
5942;32858480;6041;546;213;333
5943;80557560;6042;697;314;383
5944;21350396;6043;602;289;313
5945;32855031;6044;1275;600;675
5946;32824298;6045;826;364;462
5947;32738526;6046;569;234;335
5948;76945349;6047;505;213;292
5949;32942896;6048;771;317;454
5950;32793514;6049;770;355;415
5951;32925866;6050;600;282;318
5952;80358086;6051;664;273;391
5953;74311969;6052;1010;475;535
5954;62752706;6053;1210;509;701
5955;3862731;6054;1094;482;612
5956;27012488;6055;1375;564;811
5957;61781388;6056;1527;688;839
5958;41540263;6057;1899;798;1101
5959;32981430;6058;3000;1290;1710
5960;72665687;6059;2490;1171;1319
5961;32948240;6060;1528;688;840
5962;41341806;6061;2173;848;1325
5963;80251485;6062;1728;709;1019
5964;42854608;6063;2653;1168;1485
5965;19333739;6064;1884;867;1017
5966;32934175;6065;2309;924;1385
5967;45728062;6066;2643;1243;1400
5968;32948294;6067;2436;1097;1339
5969;71743713;6068;1626;813;813
5970;32734255;6069;2438;1146;1292
5971;53702109;6070;1607;804;803
5972;32962004;6071;3000;1200;1800
5973;32827194;6072;2067;931;1136
5974;32956385;6073;2736;1396;1340
5975;43529659;6074;2572;1029;1543
5976;71344390;6075;1872;880;992
5977;41515912;6076;1511;680;831
5978;32945668;6077;2612;1228;1384
5979;82618181;6078;2811;1153;1658
5980;36173517;6079;2692;1293;1399
5981;43880196;6080;1542;725;817
5982;70366574;6081;2155;949;1206
5983;43904312;6082;1543;664;879
5984;27675826;6083;2391;1148;1243
5985;40806737;6084;1604;786;818
5986;47984258;6085;2818;1128;1690
5987;43247528;6086;1973;928;1045
5988;43600254;6087;2318;974;1344
5989;42874845;6088;1296;597;699
5990;33260017;6089;679;326;353
5991;32736177;6090;1006;453;553
5992;32795711;6091;544;234;310
5993;32809465;6092;534;235;299
5994;41687023;6093;1139;536;603
5995;43284367;6094;629;277;352
5996;84885397;6095;866;390;476
5997;32855939;6096;1110;467;643
5998;47608250;6097;1428;672;756
5999;43533277;6098;775;357;418
6000;42957263;6099;1430;572;858
6001;45609130;6100;1212;558;654
6002;32779646;6101;2815;1183;1632
6003;32834472;6102;820;345;475
6004;32974656;6103;927;436;491
6005;92849898;6104;1054;454;600
6006;46412229;6105;687;330;357
6007;32783969;6106;1485;624;861
6008;32854140;6107;1031;423;608
6009;32740360;6108;557;240;317
6010;27749784;6109;971;389;582
6011;32822191;6110;1237;582;655
6012;32733889;6111;547;269;278
6013;47161224;6112;1319;515;804
6014;43173767;6113;2480;1216;1264
6015;32941159;6114;2292;917;1375
6016;32738033;6115;1253;627;626
6017;40545394;6116;1289;581;708
6018;32863869;6117;1213;546;667
6019;32926690;6118;997;469;528
6020;32815046;6119;1266;621;645
6021;40085553;6120;1463;600;863
6022;44852276;6121;1306;510;796
6023;48819748;6122;585;264;321
6024;32805172;6123;1049;452;597
6025;91633525;6124;713;293;420
6026;32905830;6125;941;471;470
6027;32827726;6126;946;388;558
6028;32856725;6127;568;233;335
6029;44023762;6128;2698;1188;1510
6030;40844370;6129;1524;610;914
6031;70204400;6130;2149;989;1160
6032;32976114;6131;2934;1379;1555
6033;42664554;6132;2890;1330;1560
6034;92673106;6133;2896;1275;1621
6035;41455704;6134;1798;846;952
6036;46647831;6135;2934;1291;1643
6037;32977011;6136;2170;890;1280
6038;42855523;6137;2712;1221;1491
6039;46259228;6138;2096;860;1236
6040;48359449;6139;2995;1258;1737
6041;32927960;6140;2322;1138;1184
6042;85999563;6141;1723;672;1051
6043;43404269;6142;1924;789;1135
6044;47822928;6143;2838;1448;1390
6045;34228535;6144;2685;1182;1503
6046;3689865;6145;1564;782;782
6047;44731658;6146;2188;1116;1072
6048;32819959;6147;2620;1179;1441
6049;32939916;6148;1903;819;1084
6050;46974641;6149;2189;876;1313
6051;32222274;6150;1883;735;1148
6052;32926379;6151;2520;1210;1310
6053;33262910;6152;1507;694;813
6054;32888638;6153;2998;1320;1678
6055;48070307;6154;2565;1052;1513
6056;70175380;6155;2604;1068;1536
6057;40113367;6156;2528;1163;1365
6058;32964697;6157;2721;1198;1523
6059;32969083;6158;2181;1047;1134
6060;42767115;6159;1998;999;999
6061;32920615;6160;2524;1035;1489
6062;46732337;6161;1772;745;1027
6063;32866680;6162;1963;923;1040
6064;32776919;6163;2523;1212;1311
6065;77146376;6164;1901;780;1121
6066;94661070;6165;2732;1285;1447
6067;46408962;6166;2661;1358;1303
6068;53927266;6167;1626;813;813
6069;32862239;6168;2475;1089;1386
6070;18309267;6169;1796;737;1059
6071;88998605;6170;1796;755;1041
6072;75056329;6171;2750;1293;1457
6073;46636219;6172;2005;782;1223
6074;23490849;6173;2186;1093;1093
6075;17530053;6174;1678;789;889
6076;56512876;6175;1921;923;998
6077;80706416;6176;2041;919;1122
6078;32323323;6177;2694;1374;1320
6079;57791204;6178;2369;1019;1350
6080;80312088;6179;2761;1298;1463
6081;76592720;6180;2179;981;1198
6082;41375156;6181;1871;880;991
6083;32990040;6182;1855;928;927
6084;32802556;6183;2483;1093;1390
6085;75582752;6184;2475;1089;1386
6086;44867544;6185;1517;638;879
6087;32784528;6186;1831;934;897
6088;32766421;6187;1646;774;872
6089;32762141;6188;2060;969;1091
6090;70012830;6189;1650;710;940
6091;32871937;6190;2155;1056;1099
6092;32980481;6191;1871;805;1066
6093;32820521;6192;2074;996;1078
6094;32810971;6193;2564;1103;1461
6095;32846289;6194;1826;822;1004
6096;44264351;6195;1661;748;913
6097;41450985;6196;2108;865;1243
6098;32834079;6197;2932;1349;1583
6099;32862627;6198;2972;1338;1634
6100;32839115;6199;2859;1116;1743
6101;32967812;6200;2335;934;1401
6102;70106894;6201;1728;795;933
6103;32908910;6202;1627;798;829
6104;32737193;6203;2447;1028;1419
6105;65276548;6204;2994;1198;1796
6106;43354224;6205;2675;1365;1310
6107;42843501;6206;2638;1188;1450
6108;32916128;6207;1694;712;982
6109;32822651;6208;1852;723;1129
6110;32869591;6209;1766;883;883
6111;32923436;6210;2211;885;1326
6112;32733818;6211;1729;761;968
6113;74095798;6212;1703;852;851
6114;32928832;6213;2745;1318;1427
6115;76390781;6214;2872;1293;1579
6116;72672905;6215;2715;1114;1601
6117;32967508;6216;2935;1468;1467
6118;76979534;6217;1595;654;941
6119;40707919;6218;2136;962;1174
6120;32845504;6219;2460;1009;1451
6121;80596950;6220;1686;793;893
6122;40195313;6221;2065;950;1115
6123;32840746;6222;1952;976;976
6124;42440753;6223;2352;988;1364
6125;70013020;6224;1548;620;928
6126;32785010;6225;2724;1390;1334
6127;74443864;6226;2729;1229;1500
6128;16699734;6227;2965;1305;1660
6129;32806262;6228;2525;1238;1287
6130;47644147;6229;1669;768;901
6131;43753945;6230;2182;895;1287
6132;43521124;6231;2069;1014;1055
6133;32855940;6232;2024;830;1194
6134;32926674;6233;1733;815;918
6135;32985916;6234;1724;673;1051
6136;32985915;6235;1945;837;1108
6137;46664195;6236;1715;789;926
6138;32542483;6237;1757;826;931
6139;32915041;6238;1984;814;1170
6140;40205481;6239;1639;672;967
6141;70488813;6240;2088;1065;1023
6142;41417121;6241;2326;1024;1302
6143;44223460;6242;2417;1161;1256
6144;32541203;6243;1894;891;1003
6145;41310789;6244;2166;1062;1104
6146;40784102;6245;2189;964;1225
6147;18065710;6246;1782;838;944
6148;47515369;6247;1598;799;799
6149;42332852;6248;2379;1142;1237
6150;43658964;6249;1960;922;1038
6151;32541064;6250;2086;1064;1022
6152;40491907;6251;2777;1139;1638
6153;80211580;6252;1793;736;1057
6154;42204114;6253;2887;1213;1674
6155;32406948;6254;1656;646;1010
6156;76401813;6255;2244;943;1301
6157;32542960;6256;2423;1067;1356
6158;32975054;6257;2035;1018;1017
6159;32763732;6258;2330;956;1374
6160;32833074;6259;2217;887;1330
6161;43109960;6260;2972;1278;1694
6162;32817138;6261;1893;966;927
6163;32806200;6262;1568;612;956
6164;45858336;6263;2408;1084;1324
6165;32929227;6264;1932;966;966
6166;80556747;6265;1697;662;1035
6167;43770406;6266;2386;1098;1288
6168;32926861;6267;2716;1331;1385
6169;32905559;6268;2629;1236;1393
6170;40642811;6269;2392;1077;1315
6171;32806338;6270;2265;974;1291
6172;32811311;6271;2336;1075;1261
6173;44485960;6272;1968;984;984
6174;32913137;6273;2293;1078;1215
6175;76944596;6274;2933;1203;1730
6176;76809487;6275;2046;901;1145
6177;42822704;6276;2042;838;1204
6178;16738748;6277;2242;1121;1121
6179;41187681;6278;2477;1066;1411
6180;40894888;6279;1682;841;841
6181;32824070;6280;2831;1416;1415
6182;44483720;6281;2141;878;1263
6183;41084067;6282;2694;1078;1616
6184;47920685;6283;1773;852;921
6185;32910792;6284;1700;680;1020
6186;40796014;6285;2397;1055;1342
6187;73954304;6286;1935;968;967
6188;47444512;6287;2371;949;1422
6189;32925369;6288;1997;999;998
6190;48597088;6289;2788;1339;1449
6191;77097950;6290;2461;1133;1328
6192;32925978;6291;1619;697;922
6193;32828818;6292;2542;1017;1525
6194;75785002;6293;2838;1306;1532
6195;44762507;6294;2515;1208;1307
6196;46155461;6295;2891;1186;1705
6197;40225313;6296;2931;1407;1524
6198;46564486;6297;1754;807;947
6199;44874991;6298;1919;883;1036
6200;40356504;6299;1931;850;1081
6201;80411080;6300;2644;1322;1322
6202;46544106;6301;2026;831;1195
6203;32812410;6302;2260;882;1378
6204;32864749;6303;2523;1237;1286
6205;32771249;6304;2239;918;1321
6206;46081880;6305;2992;1257;1735
6207;43401016;6306;2570;1157;1413
6208;47857100;6307;1977;772;1205
6209;40432441;6308;2727;1364;1363
6210;32530602;6309;1684;775;909
6211;72396917;6310;1878;864;1014
6212;41727288;6311;2057;1029;1028
6213;32737552;6312;2083;855;1228
6214;17112617;6313;2811;1294;1517
6215;75048629;6314;1927;925;1002
6216;98417554;6315;2250;923;1327
6217;9028850;6316;2459;1156;1303
6218;32848666;6317;2869;1406;1463
6219;32843977;6318;2886;1443;1443
6220;32945542;6319;2637;1187;1450
6221;32926846;6320;2577;1083;1494
6222;19188424;6321;2676;1098;1578
6223;70216488;6322;2736;1314;1422
6224;44659010;6323;2064;867;1197
6225;32817930;6324;2995;1228;1767
6226;7578470;6325;2684;1155;1529
6227;32859390;6326;2213;1063;1150
6228;7617635;6327;1526;733;793
6229;32737430;6328;2725;1281;1444
6230;32817557;6329;2641;1163;1478
6231;95094312;6330;1738;765;973
6232;55130243;6331;2507;1053;1454
6233;8628868;6332;2408;1036;1372
6234;32864302;6333;2804;1234;1570
6235;32841485;6334;1979;871;1108
6236;32520871;6335;1904;781;1123
6237;44982872;6336;1585;682;903
6238;42925322;6337;2526;1036;1490
6239;32938346;6338;2072;995;1077
6240;74750878;6339;2485;1069;1416
6241;75916233;6340;1613;742;871
6242;32901796;6341;2251;923;1328
6243;41408036;6342;2106;843;1263
6244;32541796;6343;2476;1164;1312
6245;48363322;6344;1648;759;889
6246;90031676;6345;2024;911;1113
6247;32971971;6346;2126;1021;1105
6248;32950964;6347;2808;1404;1404
6249;32912304;6348;2844;1195;1649
6250;45611735;6349;2304;1037;1267
6251;80281558;6350;1593;781;812
6252;69453616;6351;1951;781;1170
6253;32931274;6352;2918;1197;1721
6254;32844932;6353;2478;1190;1288
6255;32972505;6354;1926;867;1059
6256;19204345;6355;2758;1242;1516
6257;40706199;6356;1690;778;912
6258;32928574;6357;1627;814;813
6259;40338112;6358;1759;898;861
6260;41239353;6359;2117;911;1206
6261;42662222;6360;2831;1161;1670
6262;40647133;6361;2155;1056;1099
6263;80220278;6362;2930;1290;1640
6264;33260738;6363;2481;1117;1364
6265;47844825;6364;1817;873;944
6266;32908288;6365;2275;1138;1137
6267;12575601;6366;1635;785;850
6268;70129068;6367;1587;778;809
6269;51337128;6368;2812;1238;1574
6270;80596471;6369;2273;1137;1136
6271;41720733;6370;2633;1185;1448
6272;32867079;6371;1754;720;1034
6273;32488135;6372;2812;1350;1462
6274;80503916;6373;2624;1076;1548
6275;23923945;6374;2344;938;1406
6276;74659920;6375;2326;1047;1279
6277;32738715;6376;2065;992;1073
6278;40005678;6377;1568;659;909
6279;41258879;6378;2169;998;1171
6280;32978245;6379;1628;814;814
6281;75188618;6380;1571;676;895
6282;76006347;6381;1794;862;932
6283;32981934;6382;2709;1192;1517
6284;48552948;6383;1603;722;881
6285;32981951;6384;2777;1361;1416
6286;46911089;6385;2778;1139;1639
6287;72835031;6386;1721;792;929
6288;70014998;6387;1572;786;786
6289;45981921;6388;1924;809;1115
6290;41282005;6389;1732;728;1004
6291;41342785;6390;2732;1121;1611
6292;46867994;6391;2430;1191;1239
6293;32971829;6392;2003;862;1141
6294;76049360;6393;2400;1128;1272
6295;32973369;6394;2681;1234;1447
6296;41445813;6395;2426;1141;1285
6297;32802390;6396;2438;1098;1340
6298;73300430;6397;2248;1012;1236
6299;76439035;6398;2013;786;1227
6300;73299532;6399;1549;682;867
6301;48366536;6400;2453;1080;1373
6302;76855515;6401;2699;1080;1619
6303;60988729;6402;1577;757;820
6304;73528109;6403;2299;1081;1218
6305;46906128;6404;2234;1073;1161
6306;32931735;6405;2098;861;1237
6307;40596855;6406;1690;812;878
6308;32904684;6407;2263;1087;1176
6309;19261678;6408;2951;1240;1711
6310;48677218;6409;1676;704;972
6311;32796069;6410;2739;1343;1396
6312;44852262;6411;2312;972;1340
6313;32829069;6412;2079;894;1185
6314;43006006;6413;2449;1127;1322
6315;43799166;6414;2036;978;1058
6316;68291046;6415;1633;768;865
6317;32818208;6416;2339;913;1426
6318;44332360;6417;2771;1081;1690
6319;47175175;6418;1769;814;955
6320;70973201;6419;1946;915;1031
6321;32912768;6420;1921;750;1171
6322;32924156;6421;2493;1048;1445
6323;32911944;6422;2763;1327;1436
6324;32907181;6423;2081;833;1248
6325;48117067;6424;2024;810;1214
6326;42219846;6425;2162;1038;1124
6327;46623598;6426;1771;744;1027
6328;41474133;6427;1577;710;867
6329;72185028;6428;1748;805;943
6330;47985651;6429;2835;1361;1474
6331;48762347;6430;1873;768;1105
6332;32984640;6431;1930;985;945
6333;43902754;6432;2996;1439;1557
6334;42518380;6433;2369;1138;1231
6335;46621315;6434;1741;888;853
6336;76811500;6435;2606;1121;1485
6337;44295911;6436;1771;709;1062
6338;75910736;6437;2911;1252;1659
6339;32740893;6438;2484;1093;1391
6340;40065412;6439;1979;851;1128
6341;70168579;6440;2683;1235;1448
6342;32917993;6441;2777;1250;1527
6343;60788792;6442;2147;1095;1052
6344;72843280;6443;1524;595;929
6345;76067489;6444;2555;1176;1379
6346;70121205;6445;2835;1390;1445
6347;43451367;6446;2589;1243;1346
6348;46211812;6447;2447;1175;1272
6349;46461125;6448;2463;1010;1453
6350;98307333;6449;2923;1433;1490
6351;46812914;6450;2925;1375;1550
6352;40162331;6451;2477;991;1486
6353;42740072;6452;2414;1183;1231
6354;46759573;6453;2737;1232;1505
6355;32817079;6454;2689;1318;1371
6356;71414369;6455;1963;766;1197
6357;73795812;6456;2500;1150;1350
6358;32941280;6457;2795;1286;1509
6359;32962909;6458;1852;834;1018
6360;32986668;6459;2367;1089;1278
6361;32985726;6460;2907;1251;1656
6362;92802044;6461;2788;1283;1505
6363;69961472;6462;1842;756;1086
6364;69149982;6463;1960;980;980
6365;32866830;6464;2636;1266;1370
6366;48684999;6465;1562;610;952
6367;48337032;6466;2487;970;1517
6368;32792455;6467;2459;1230;1229
6369;80401669;6468;2956;1242;1714
6370;45794336;6469;1883;773;1110
6371;32980535;6470;2568;1105;1463
6372;43560503;6471;2361;1157;1204
6373;76308660;6472;1888;775;1113
6374;78000592;6473;2552;1072;1480
6375;10778879;6474;2800;1176;1624
6376;66491062;6475;2833;1190;1643
6377;85792309;6476;2158;1101;1057
6378;79597821;6477;1710;684;1026
6379;32865275;6478;2159;929;1230
6380;32976095;6479;1661;814;847
6381;73376743;6480;2554;1124;1430
6382;73636748;6481;1960;784;1176
6383;32966353;6482;2058;1009;1049
6384;33262231;6483;2157;885;1272
6385;44723709;6484;1747;857;890
6386;42515942;6485;1993;917;1076
6387;41070820;6486;2876;1151;1725
6388;2879528;6487;1809;778;1031
6389;32784139;6488;1659;830;829
6390;44413873;6489;1651;843;808
6391;92494704;6490;1694;831;863
6392;43961459;6491;2669;1362;1307
6393;75396788;6492;2433;1217;1216
6394;33265893;6493;2717;1114;1603
6395;75098825;6494;2369;948;1421
6396;41369721;6495;1963;766;1197
6397;75098824;6496;2286;1143;1143
6398;42666129;6497;1985;874;1111
6399;40231732;6498;1694;864;830
6400;32986918;6499;1534;737;797
6401;14431279;6500;1913;842;1071
6402;47612252;6501;1740;836;904
6403;47399163;6502;1999;800;1199
6404;43774770;6503;1872;918;954
6405;80336892;6504;2312;972;1340
6406;74764633;6505;2009;1005;1004
6407;32783247;6506;2003;862;1141
6408;32804795;6507;1841;921;920
6409;32783816;6508;2561;1076;1485
6410;32740314;6509;2026;811;1215
6411;71081107;6510;1589;684;905
6412;43541585;6511;2579;1109;1470
6413;42642207;6512;2523;1237;1286
6414;75396892;6513;1731;831;900
6415;76730706;6514;2117;974;1143
6416;32921749;6515;2892;1360;1532
6417;48053732;6516;2493;1272;1221
6418;40551007;6517;2294;964;1330
6419;42761794;6518;2167;867;1300
6420;42806700;6519;2647;1086;1561
6421;76333115;6520;2060;927;1133
6422;42787428;6521;1891;814;1077
6423;77803034;6522;1702;681;1021
6424;32820827;6523;2433;949;1484
6425;32825676;6524;2411;989;1422
6426;82512284;6525;2241;1076;1165
6427;45026582;6526;2488;1021;1467
6428;43790906;6527;2991;1376;1615
6429;9117039;6528;2291;1123;1168
6430;33265686;6529;2705;1191;1514
6431;73387417;6530;1662;798;864
6432;32954595;6531;2645;1191;1454
6433;41701714;6532;2277;934;1343
6434;32921167;6533;2359;1015;1344
6435;70228329;6534;2558;1203;1355
6436;73326942;6535;2703;1325;1378
6437;71411193;6536;1736;712;1024
6438;44944457;6537;2692;1266;1426
6439;98129843;6538;1967;886;1081
6440;40470237;6539;2375;1093;1282
6441;32938822;6540;1869;860;1009
6442;46900328;6541;1919;902;1017
6443;32962293;6542;1762;741;1021
6444;75189786;6543;2863;1232;1631
6445;32988413;6544;1698;833;865
6446;18033285;6545;1650;693;957
6447;32857904;6546;2994;1288;1706
6448;40937446;6547;2044;1022;1022
6449;42925312;6548;1954;860;1094
6450;70169816;6549;2534;1166;1368
6451;43088583;6550;2771;1275;1496
6452;70169817;6551;1783;767;1016
6453;32901200;6552;1644;790;854
6454;73741146;6553;1935;852;1083
6455;70264864;6554;2781;1169;1612
6456;32765392;6555;2525;985;1540
6457;77710199;6556;1541;648;893
6458;45627036;6557;2788;1311;1477
6459;48280736;6558;2722;1062;1660
6460;32914264;6559;2750;1375;1375
6461;32901904;6560;2358;1062;1296
6462;32938316;6561;1953;899;1054
6463;70169922;6562;2040;918;1122
6464;74750178;6563;1980;891;1089
6465;75916213;6564;2067;807;1260
6466;45361705;6565;1542;756;786
6467;32278610;6566;2348;1057;1291
6468;47452803;6567;1525;626;899
6469;45484090;6568;1994;958;1036
6470;47336330;6569;2613;1020;1593
6471;40066298;6570;1800;738;1062
6472;46647901;6571;2589;1114;1475
6473;46397726;6572;2628;1052;1576
6474;45763618;6573;1691;728;963
6475;43895428;6574;2430;997;1433
6476;40874784;6575;1700;816;884
6477;43562850;6576;2644;1190;1454
6478;71529125;6577;2813;1126;1687
6479;46288636;6578;2889;1185;1704
6480;32802394;6579;1874;844;1030
6481;73299534;6580;2494;1247;1247
6482;32981954;6581;2297;1103;1194
6483;75191505;6582;2401;1201;1200
6484;41361072;6583;2718;1278;1440
6485;46895477;6584;1987;835;1152
6486;47690013;6585;1993;937;1056
6487;74888048;6586;1802;775;1027
6488;42414634;6587;1748;805;943
6489;32971372;6588;2802;1149;1653
6490;74765082;6589;2081;1062;1019
6491;80249305;6590;2166;932;1234
6492;9638025;6591;1926;848;1078
6493;47041646;6592;2547;1121;1426
6494;32990967;6593;2163;887;1276
6495;70289754;6594;1701;868;833
6496;70310589;6595;2354;1083;1271
6497;32964446;6596;1513;757;756
6498;16592576;6597;1633;817;816
6499;32932317;6598;2853;1313;1540
6500;32965931;6599;1771;762;1009
6501;33263373;6600;2117;868;1249
6502;40213910;6601;2125;872;1253
6503;45874472;6602;1614;727;887
6504;42572280;6603;1713;737;976
6505;76089743;6604;2666;1094;1572
6506;46363916;6605;1502;631;871
6507;32781148;6606;2645;1191;1454
6508;32942778;6607;2902;1393;1509
6509;29629451;6608;1844;738;1106
6510;70101776;6609;2276;979;1297
6511;46864685;6610;2243;943;1300
6512;44640446;6611;2994;1348;1646
6513;48179839;6612;2517;1183;1334
6514;27749650;6613;2747;1154;1593
6515;8654577;6614;1781;784;997
6516;40223169;6615;2855;1428;1427
6517;44309731;6616;2069;1014;1055
6518;72606124;6617;2871;1120;1751
6519;32919396;6618;1551;729;822
6520;40982350;6619;2353;1083;1270
6521;73591991;6620;1586;762;824
6522;42234577;6621;2774;1387;1387
6523;32923799;6622;1725;811;914
6524;40142671;6623;1525;717;808
6525;16640195;6624;2399;1176;1223
6526;70562660;6625;2830;1331;1499
6527;42270061;6626;2500;1025;1475
6528;72886981;6627;1736;764;972
6529;70133405;6628;1568;643;925
6530;42414632;6629;2186;1050;1136
6531;1013384;6630;1664;666;998
6532;32945407;6631;2160;929;1231
6533;43307406;6632;1596;798;798
6534;48237641;6633;2338;1099;1239
6535;32739378;6634;1716;773;943
6536;32965987;6635;2105;1011;1094
6537;71954124;6636;2900;1247;1653
6538;32970101;6637;1812;780;1032
6539;44909428;6638;2446;1126;1320
6540;73222978;6639;2506;1103;1403
6541;5615144;6640;2647;1271;1376
6542;45851191;6641;2164;866;1298
6543;72479349;6642;1536;784;752
6544;61004550;6643;1641;788;853
6545;32877644;6644;2663;1119;1544
6546;32737695;6645;2431;1167;1264
6547;72641103;6646;2664;1173;1491
